= Region =

== Source ==

CODECODE - blazon for the escutcheon - Armiger - Source

= English =

== Falkirk Roll ==

ENAAAAAA - or, a lion rampant purpure - Henry de Lacy - Falkirk Roll
ENAAAAAB - azure, a bend argent cotised between six lions rampant or - Humphrey de Bohun - Falkirk Roll
ENAAAAAC - per pale or and vert, a lion rampant gules - Roger le Bigod - Falkirk Roll
ENAAAAAD - azure, a bend argent cotised between six lions rampant or, a label gules - Humphrey de Bohun - Falkirk Roll
ENAAAAAE - quarterly or and gules, a bend sable - Robert FitzRoger - Falkirk Roll
ENAAAAAF - or, a fess between two chevrons gules - Robert FitzWalter - Falkirk Roll
ENAAAAAG - sable, a lion rampant argent crowned or - John Segrave - Falkirk Roll
ENAAAAAH - gules bezanty - Alan de la Zouche - Falkirk Roll
ENAAAAAI - checky or and gules, a chief ermine - Robert de Tattershall - Falkirk Roll
ENAAAAAJ - azure, three cinquefoils or - Hugh Bardolf - Falkirk Roll
ENAAAAAK - sable, a lion rampant argent crowned or, a label gules - Nicholas Segrave - Falkirk Roll
ENAAAAAL - chequy argent and gules - Walter de Mouncy - Falkirk Roll
ENAAAAAM - barry wavy of eight or and gules - John Lovel - Falkirk Roll
ENAAAAAN - chequy or and gules, a chief ermine, a label azure - Robert de Tattershall - Falkirk Roll
ENAAAAAO - azure, a lion rampant argent - Robert de Mohaut - Falkirk Roll
ENAAAAAP - barry argent and azure - Henry de Grey - Falkirk Roll
ENAAAAAQ - quarterly or and gules, a bend sable, a label azure - John de Clavering - Falkirk Roll
ENAAAAAR - or, a fess dancetty sable - William le Vavasour - Falkirk Roll
ENAAAAAS - gules fretty argent - John de Huddleston - Falkirk Roll
ENAAAAAT - argent, a chevron gules - Henry le Tyes - Falkirk Roll
ENAAAAAU - gules fretty or - Nicholas de Audley - Falkirk Roll
ENAAAAAV - gules, a cross moline ermine - Anthony Bek - Falkirk Roll
ENAAAAAW - gules, a lion rampant, a bordure argent semy of cinquefoils gules - Patrick Dunbar - Falkirk Roll
ENAAAAAX - gules crusilly, a cinquefoil or - Gilbert de Unfraville - Falkirk Roll
ENAAAAAY - or, two bars gules, in chief three torteaux - John Wake - Falkirk Roll
ENAAAAAZ - or, a bend sable - Piers de Mauley - Falkirk Roll
ENAAAAAa - or, two ravens sable - Piers Corbet - Falkirk Roll
ENAAAAAb - argent, an orle gules - Alexander de Balliol - Falkirk Roll
ENAAAAAc - or, four pallets gules, a canton ermine - Ralph Basset - Falkirk Roll
ENAAAAAd - barry of twelve or and gules - Brian FitzAlan - Falkirk Roll
ENAAAAAe - azure crusilly, a lion double queued rampant or - William de Brewes - Falkirk Roll
ENAAAAAf - sable, a cross moline or - William Sampson - Falkirk Roll
ENAAAAAg - gules, three water-bougets argent - William de Ros - Falkirk Roll
ENAAAAAh - ermine, two bars gemelles gules - Walter de Huntercombe - Falkirk Roll
ENAAAAAi - or, a maunch gules, a label azure - Edmund de Hastings - Falkirk Roll
ENAAAAAj - gules, a lion rampant, a bordure argent semy of cinquefoils gules, a label azure - Patrick de Dunbar - Falkirk Roll
ENAAAAAk - argent, a fess gules between three popinjays vert - Marmaduke de Thweng - Falkirk Roll
ENAAAAAl - barry argent and azure, a bend gules - John de Grey - Falkirk Roll
ENAAAAAm - azure, three leopard faces jessant-de-lis or - John de Cauntelo - Falkirk Roll
ENAAAAAn - argent, three cinquefoils gules - Philip Darcy - Falkirk Roll
ENAAAAAo - barry of twelve argent and azure, three chaplets gules - Ralph FitzWilliam - Falkirk Roll
ENAAAAAp - argent, two bars azure - Robert de Hilton - Falkirk Roll
ENAAAAAq - vert, a maunch or - John Paynel - Falkirk Roll
ENAAAAAr - argent, two bars gules - William Martin - Falkirk Roll
ENAAAAAs - or fretty gules, a label azure - Theobald de Verdun - Falkirk Roll
ENAAAAAt - barry of twelve argent and gules - Thomas de Multon - Falkirk Roll
ENAAAAAu - azure billetty, a fess indented or - Edmund Deincourt - Falkirk Roll
ENAAAAAv - argent, a lion rampant gules charged on the shoulder with a cinquefoil argent - Andrew de Astley - Falkirk Roll
ENAAAAAw - gules, a fess chequy argent and azure - Alexander Lindsay - Falkirk Roll
ENAAAAAx - gules, three lions passant guardant in pale or - Edward I - Falkirk Roll
ENAAAAAy - gules, three lions passant guardant or, a label azure semy-de-lis or - Thomas de Lancaster - Falkirk Roll
ENAAAAAz - gules, a fess between six crosses crosslet or - Guy de Beauchamp - Falkirk Roll
ENAAAAA0 - gules, three lions passant guardant, a bend azure - Henry de Lancaster - Falkirk Roll
ENAAAAA1 - chequy or and azure, a bordure gules semy of lions passant guardant or, a canton ermine - John de Brittany - Falkirk Roll
ENAAAAA2 - azure crusilly fitchy or, two barbels addorsed or, a bordure indented gules - John de Bar - Falkirk Roll
ENAAAAA3 - quarterly: first and fourth, argent; second and third, gules fretty or, a bendlet sable - Hugh le Despenser - Falkirk Roll
ENAAAAA4 - chequy or and azure, a fess gules - Robert de Clifford - Falkirk Roll
ENAAAAA5 - gules - Amanieu VII - Falkirk Roll
ENAAAAA6 - gules, a castle or - Pons de Castillon - Falkirk Roll
ENAAAAA7 - paly gules and or, a canton ermine, a bordure sable bezanty - Pierre Amanieu - Falkirk Roll
ENAAAAA8 - gules, seven mascles conjoined or - William de Ferrers - Falkirk Roll
ENAAAAA9 - barry argent and azure, a label gules - Reynold de Grey - Falkirk Roll
ENAAAAA+ - argent, two bars gules, in chief three torteaux - John de Moels - Falkirk Roll
ENAAAAA/ - gules, a cross patoncy or - William le Latimer - Falkirk Roll
ENAAAABA - gules crusilly or, a fess dancetty or - John de Engaine - Falkirk Roll
ENAAAABB - argent, a maunch gules - Robert de Tony - Falkirk Roll
ENAAAABC - gules, three lions passant argent, a bend azure - Robert FitzPayne - Falkirk Roll
ENAAAABD - or, a lion rampant double queued sable - Adam de Well - Falkirk Roll
ENAAAABE - barry, a chief paly, the corners gyronny, or and azure, an inescutcheon ermine - Roger de Mortimer - Falkirk Roll *
ENAAAABF - argent, a bend between six martlets gules - Thomas de Furnival - Falkirk Roll
ENAAAABG - or, a fess indented gules - Henry de Pinkeny - Falkirk Roll
ENAAAABH - gules, a maunch argent - John de la Mare - Falkirk Roll
ENAAAABI - gules, a fess vair - William de Cauntelo - Falkirk Roll
ENAAAABJ - argent, on a cross gules five mullets or - John ap Adam - Falkirk Roll
ENAAAABK - or, a saltire indented sable - John Botetourt - Falkirk Roll
ENAAAABL - or, a cross indented gules - Eustace de Hatch - Falkirk Roll
ENAAAABM - azure, three bars gemelles, a chief or - Nicholas de Meinill - Falkirk Roll
ENAAAABN - or, two bars gemelles gules, in chief a lion passant guardant gules - John de Tregoz - Falkirk Roll
ENAAAABO - sable, a cross flory argent - Richard Siward - Falkirk Roll
ENAAAABP - sable, six cinquefoils argent - Simon Fraser - Falkirk Roll
ENAAAABQ - or, a fess gules - William FitzWilliam - Falkirk Roll
ENAAAABR - argent, a fess between two chevrons gules - Gilbert Pecche - Falkirk Roll
ENAAAABS - gules semy of escallops argent - Robert de Scales - Falkirk Roll
ENAAAABT - gules, a fess between six martlets or - Walter de Beauchamp - Falkirk Roll
ENAAAABU - paly argent and azure - Piers de Chauvent - Falkirk Roll
ENAAAABV - azure semy of crescents or - William de Ryther - Falkirk Roll
ENAAAABW - quarterly or and azure, four cinquefoils counterchanged - John de Droxford - Falkirk Roll
ENAAAABX - gules, a cross clechy voided and botonny argent - John de Benstede - Falkirk Roll
ENAAAABY - argent, a lion rampant gules collared or - John de Havering - Falkirk Roll
ENAAAABZ - paly argent and azure, on a bend gules three eagles displayed or - William de Grandison - Falkirk Roll
ENAAAABa - gules, two bars vair - Hugh de Mortimer - Falkirk Roll
ENAAAABb - or, a greyhound courant gules collared sable, a bordure sable bezanty - Pierre de Bordeaux - Falkirk Roll
ENAAAABc - or, three magpies sable - Otton de Cazeneuze - Falkirk Roll
ENAAAABd - quarterly: first and fourth, argent, three fusils conjoined gules; second and third, azure, a griffin segreant or - Simon de Montagu - Falkirk Roll
ENAAAABe - lozengy or and gules - John de Rivers - Falkirk Roll
ENAAAABf - or, on a fess between two chevrons gules three mullets or - Walter de Teye - Falkirk Roll
ENAAAABg - chequy or and azure - John de Warenne - Falkirk Roll
ENAAAABh - or, an eagle displayed vert - Ralph de Monthermer - Falkirk Roll
ENAAAABi - quarterly or and gules, in first quarter a mullet argent - Robert de Vere - Falkirk Roll
ENAAAABj - gules, a lion rampant or - Richard FitzAlan - Falkirk Roll
ENAAAABk - barry of ten argent and azure, an orle of martlets gules - Aymer de Valence - Falkirk Roll
ENAAAABl - or, a lion rampant azure - Henry de Percy - Falkirk Roll
ENAAAABm - gules semy of crosses patty argent, a chevron argent - Thomas de Berkeley - Falkirk Roll
ENAAAABn - or, a fess gules, a semy-de-lis counterchanged - John Deiville - Falkirk Roll
ENAAAABo - vairy argent and sable - Robert de Ward - Falkirk Roll
ENAAAABp - argent, on a chief gules two mullets or, a label azure - John de St John - Falkirk Roll
ENAAAABq - argent, a lion rampant double queued sable - William de Morley - Falkirk Roll
ENAAAABr - gules, a cross patoncy or, a label argent - William le Latimer - Falkirk Roll
ENAAAABs - vair - John de Beauchamp - Falkirk Roll
ENAAAABt - argent, two bars, on a canton azure a cinquefoil or - Ralph Pipard - Falkirk Roll
ENAAAABu - barry of eight or and gules - Hugh Poyntz - Falkirk Roll
ENAAAABv - argent, two chevrons gules - Ralph de Grendon - Falkirk Roll
ENAAAABw - or, a cross indented sable - John de Mohun - Falkirk Roll
ENAAAABx - gules, semy of crosses patty, a chevron argent, a label azure - Maurice de Berkeley - Falkirk Roll
ENAAAABy - or, three torteaux, a label azure - Hugh de Courtenay - Falkirk Roll

== Dering Roll ==

ENAAAABz - gules, two lions passant guardant or - Richard FitzRoy - Dering Roll
ENAAAAB0 - quarterly or and gules - William de Say - Dering Roll
ENAAAAB1 - or, a cross voided gules - Robert de Crevquer - Dering Roll
ENAAAAB2 - azure, six lions rampant argent - William de Leiborne - Dering Roll
ENAAAAB3 - or, six lions rampant sable - Roger de Leiborne - Dering Roll
ENAAAAB4 - gules, a cross argent - Stephen de Penchester - Dering Roll
ENAAAAB5 - azure, a lion rampant argent - Robert de Colville - Dering Roll
ENAAAAB6 - gules, a fess between two bars gemelles argent - Ralph de Normanville - Dering Roll
ENAAAAB7 - azure, three winnowing fans or - Robert de Septvans - Dering Roll
ENAAAAB8 - azure, a chief indented or - Ralph de Sandwich - Dering Roll
ENAAAAB9 - ermine, a cross indented gules - Roger de Northwode - Dering Roll
ENAAAAB+ - gules, on a chevron or three fleur-de-lis azure - John de Cobham - Dering Roll
ENAAAAB/ - or, a chief indented azure - John de Sandwich - Dering Roll
ENAAAACA - or, two chevrons and a canton gules - Bertram de Criel - Dering Roll
ENAAAACB - gules semy-de-lis or, a cross argent - Henry de Cobham - Dering Roll
ENAAAACC - azure, a sun in his splendor or - Thomas de Adeham - Dering Roll
ENAAAACD - argent, three fleirs-de-lis sable - William de Barming - Dering Roll
ENAAAACE - azure fretty argent, a chief or - Ralph de Saint Leger - Dering Roll
ENAAAACF - ermine, a fess between two bars gemelles gules - Ralph de Badlesmere - Dering Roll
ENAAAACG - azure, six lions rampant, overall a canton ermine - Roger de Shirland - Dering Roll
ENAAAACH - argent, a fess between two bars gemelles gules - Guncelin de Badlesmere - Dering Roll
ENAAAACI - or, on a cross sable five eagles displayed argent - Nicholas Abelin - Dering Roll
ENAAAACJ - argent, a fess between two bars gemelles gules - ??? Badlesmere - Dering Roll
ENAAAACK - azure, a bend gules cotised between six boar's heads erased or - Ralph de Eastling - Dering Roll
ENAAAACL - gules, three bars wavy gules - Robert de Champagne - Dering Roll
ENAAAACM - gules fretty argent - Waris de Valoynes - Dering Roll
ENAAAACN - argent, three pallets wavy - William de Valoynes - Dering Roll
ENAAAACO - azure crusilly of crosses crosslet, three cinquefoils or - Stephen de Cossington - Dering Roll
ENAAAACP - ermine, a cross voided gules - Ralph de Otterden - Dering Roll
ENAAAACQ - or, two chevrons, on a canton gules a lion rampant argent - William de Orlestone - Dering Roll
ENAAAACR - gules, a cross engrailed or - Simon de Cray - Dering Roll
ENAAAACS - argent, between three annulets a fess gules - William de Fawkham - Dering Roll
ENAAAACT - or, two chevrons, on a canton gules a crescent argent - Nicholas de Hadlow - Dering Roll
ENAAAACU - argent, three lions rampant sable - William le Jone - Dering Roll
ENAAAACV - gules, a cross argent, a label azure - William de Hever - Dering Roll
ENAAAACW - ermine, on a bend azure three lions rampant argent - John de Bourne - Dering Roll
ENAAAACX - sable, six lions rampant argent - William de Detling - Dering Roll
ENAAAACY - ermine, a bend gules - Henry de Apuldrefield - Dering Roll
ENAAAACZ - quarterly per fess indented or and azure - Ralph Perot - Dering Roll
ENAAAACa - ermine, a bend vairy or and gules - Henry de Apuldrefield - Dering Roll
ENAAAACb - azure, between six lions rampant argent a fess gules - John de Ruxley - Dering Roll
ENAAAACc - sable crusilly, three hakes argent - Ralph Hacket - Dering Roll
ENAAAACd - ermine, a lion rampant gules, overall a chevron or - Robert de Hardres - Dering Roll
ENAAAACe - per fess dancetty or and azure, in chief three torteaux - Stephen de Boughton - Dering Roll
ENAAAACf - ermine, on a fess azure three lions rampant argent - Nicholas Peysun - Dering Roll
ENAAAACg - or, on a fess gules three lozenges vair - William de Apeldrefield - Dering Roll
ENAAAACh - ermine, on a cross gules five martlets or - Robert de Scotto - Dering Roll
ENAAAACi - or, on a hurt azure a cinquefoil or, on a chief indented azure two bezants -  Water de Gosehale - Dering Roll
ENAAAACj - quarterly or and gules, a label sable semy of bezants - Peres de Hontingfeld - Dering Roll
ENAAAACk - azure, two bends argent - Bertram Tancre - Dering Roll
ENAAAACl - gules, a cross or fretty sable - Lawrence de Saint Michael - Dering Roll
ENAAAACm - argent, six lions rampant sable - Bertelmeu de Woteringeberi - Dering Roll
ENAAAACn - gules, six lions rampant ermine - Roger de Tilmanstone - Dering Roll
ENAAAACo - azure, three bends argent - Stefne Sodan - Dering Roll
ENAAAACp - lozengy gules and vair, a canton or - Auncel de Gise - Dering Roll
ENAAAACq - argent, on a chief azure three lions rampant argent crowned or - John de Bikenore - Dering Roll
ENAAAACr - quarterly or and gules, a label azure - Alexander de Chene - Dering Roll
ENAAAACs - azure, six annulets or - John de Pecham - Dering Roll
ENAAAACt - argent crusilly sable, a chevron gules - William de Merwrthe - Dering Roll
ENAAAACu - azure crusilly and three pikes or - Eymeri de Luci - Dering Roll
ENAAAACv - per fess or and gules - Nicholas de Criel - Dering Roll
ENAAAACw - or, a cross indented gules - Thomas de Marines - Dering Roll
ENAAAACx - gules, three hands or - Henry Malemein - Dering Roll
ENAAAACy - or, three escutcheons barry vair and gules - William Monchensi - Dering Roll
ENAAAACz - or, three mallets gules - Richard Martel - Dering Roll
ENAAAAC0 - sable, three bear heads argent - Ralph de Levelande - Dering Roll
ENAAAAC1 - argent, six fleur-de-lis sable - William Peyfrer - Dering Roll
ENAAAAC2 - or, two cherons and on a canton gules three leopard heads affronty or - Roger de Romenal - Dering Roll
ENAAAAC3 - argent, three cinquefoils sable - Alan de Tuitham - Dering Roll
ENAAAAC4 - azure, six leopard faces or - Yvon de Silingheld - Dering Roll
ENAAAAC5 - argent, five chevronels sable - Robert de Hugham - Dering Roll
ENAAAAC6 - or, on a chief azure three lions rampant argent - Thomas de Sanduiz - Dering Roll
ENAAAAC7 - ermine, on a chief azure three lions rampant or - Ralph Savage - Dering Roll
ENAAAAC8 - azure, three lions rampant or, a chief argent - Nicholas le Gras - Dering Roll
ENAAAAC9 - argent, a cross gules fretty or between four birds sable - Nicholas de Ore - Dering Roll
ENAAAAC+ - argent, on a chief gules three birds or - Bertelmeu de Morstone - Dering Roll
ENAAAAC/ - chequy argent and azure - Hamon de Gattone - Dering Roll
ENAAAADA - sable, a cross indented or - Robert d'Ufford - Dering Roll
ENAAAADB - or, a cross indented gules - ??? Marines - Dering Roll
ENAAAADC - gyronny azure and or - Warin de Bassingbourne - Dering Roll
ENAAAADD - ermine, a bend sinister indented gules - Alan Plokenet - Dering Roll
ENAAAADE - or, two bars and in chief three torteaux - Baudewin Wake - Dering Roll
ENAAAADF - azure, four bends or - Peres de Muntford - Dering Roll
ENAAAADG - or, a cross sable, a label gules - William de Vesci - Dering Roll
ENAAAADH - gules, a lion rampant or - John le FitzAlan - Dering Roll
ENAAAADI - azure crusilly and a lion rampant or - William de Breouse - Dering Roll
ENAAAADJ - gules, a fleur-de-lis argent - Robert Agilon - Dering Roll
ENAAAADK - azure, three cinquefoils or - William Bardolf - Dering Roll
ENAAAADL - vair, a fess gules - William Marmion - Dering Roll
ENAAAADM - azure, two bars gemelles and in chief a lion passant guardant or - Henry Tregoz - Dering Roll
ENAAAADN - argent, on a chief gules two mullets or - John de Saint Jojn - Dering Roll
ENAAAADO - or, a cross azure - John de Boun - Dering Roll
ENAAAADP - azure, a fess indented or - Henry de Percy - Dering Roll
ENAAAADQ - ermine, three bars gules - Henry Heuse - Dering Roll
ENAAAADR - azure fretty or - Richard de Mandevile - Dering Roll
ENAAAADS - or, on a chief gules three plate - John de Cameys - Dering Roll
ENAAAADT - azure, a chief chequy or and gules - Robert de Porpount - Dering Roll
ENAAAADU - chequy or and gules, a chief azure - Simon de Perpont - Dering Roll
ENAAAADV - argent, a bend sable - Walram de Muntceaus - Dering Roll
ENAAAADW - azure fretty argent - William de Echingham - Dering Roll
ENAAAADX - gules, a fess ermine - Richard Waleys - Dering Roll
ENAAAADY - sable, a fess indented argent - John de Percy - Dering Roll
ENAAAADZ - gules crusilly and a lion rampant argent - Roger la Ware - Dering Roll
ENAAAADa - argent, a sun in his splendour gules - John de la Haye - Dering Roll
ENAAAADb - azure crusilly and six herrings or - William Heringod - Dering Roll
ENAAAADc - barry or and vert, a bend gules - Lucas de Poninge - Dering Roll
ENAAAADd - argent, a fess between three lozenges azure - William de Hastinge - Dering Roll
ENAAAADe - azure, a fess indented argent, a label gules - William de Autrive - Dering Roll
ENAAAADf - gules, a maunch or - John de Munceus - Dering Roll
ENAAAADg - azure crusilly and three crescents or - Hugh Sanz Aver - Dering Roll
ENAAAADh - azure, a chevron or fretty gules between three crosses flory argent - Richard de Pevenese - Dering Roll
ENAAAADi - Gules, three hands argent - Nicholas Malemeyns - Dering Roll
ENAAAADj - Gyronny gules and argent, a bordure sable bezanty - Thomas Peverel - Dering Roll
ENAAAADk -  - William Grandin - Dering Roll
ENAAAADl - argent semy of escallops gules, a lion rampant sable - William Maufe - Dering Roll
ENAAAADm - gules, a fleur-de-lis ermine - Robert de Cokefeld - Dering Roll
ENAAAADn - azure - Robert le Poer - Dering Roll
ENAAAADo - sable crusilly and three crescents argent - William FitzLel - Dering Roll
ENAAAADp - azure fretty argent, a chief gules - William Seint Leger - Dering Roll
ENAAAADq - gules, a crescent or, on a chief argent two mullets gules - John Peche - Dering Roll
ENAAAADr - argent, a chief indented sable - Adam de Bavent - Dering Roll
ENAAAADs - lozengy or and azure - Thomas de Warbotone - Dering Roll
ENAAAADt - gules, a fess ermine, in chief two mullets or - Roger le Covert - Dering Roll
ENAAAADu - quarterly argent and azure - William de Northie - Dering Roll
ENAAAADv - argent, within an orle of martlets gules two bars sable - William Paynel - Dering Roll
ENAAAADw - or, within an orle of martlets gules two bars azure - Thomas Paynel - Dering Roll
ENAAAADx - azure, three chevronels argent - Roger de Leukenore - Dering Roll
ENAAAADy - argent, three crescent and a canton gules - Ralph de Stopeham - Dering Roll
ENAAAADz - gules, a fess aargent, in chief three mullets or - Richard de Esbornham - Dering Roll
ENAAAAD0 - argent, three cinquefoils and a canton gules - John Mowin - Dering Roll
ENAAAAD1 - argent, on a bend sable three calves argent - Robert de Vel - Dering Roll
ENAAAAD2 - gules crusilly and two trumpets pilewise or - Lawrence de Neville - Dering Roll
ENAAAAD3 - gules a lion rampant queued fourchy or, a label azure - Herbert de Borgherse - Dering Roll
ENAAAAD4 - quarterly or and gules, a bend vair - Andrew de Sakevile - Dering Roll
ENAAAAD5 - azure crusilly and a fess dancetty argent - Lucas de Viene - Dering Roll
ENAAAAD6 - argent, two bars gemelles and in chief a lion passant gules - Richard de Feringes - Dering Roll
ENAAAAD7 - argent crusilly gules, a lion rampant sable - Robert Livet - Dering Roll
ENAAAAD8 - gules, a maunch argent - John de la Mare - Dering Roll
ENAAAAD9 - argent, a bordure gules bezanty - William de Bodiham - Dering Roll
ENAAAAD+ - chequy gules and or, a chief azure - Hamon Bonet - Dering Roll
ENAAAAD/ - or, three water bougets azure - Hugh de Boues - Dering Roll
ENAAAAEA - azure, a fleur-de-lis argent - William Agilon - Dering Roll
ENAAAAEB - barry argent and azure, a bend gules bezanty - Ricard de Ore - Dering Roll
ENAAAAEC - azure fretty argent, on a canton or a fleur-de-lis gules - Simon de Someri - Dering Roll
ENAAAAED -  - Water Giffard - Dering Roll
ENAAAAEE - or, six eagles displayed sable - Richard Tani - Dering Roll
ENAAAAEF - gyronny azure and argent - Bartholomew de Briançon - Dering Roll
ENAAAAEG - quarterly or and vert - Ralph de Bernes - Dering Roll
ENAAAAEH - or, two bends gules - Bartholomew de Sule - Dering Roll
ENAAAAEI - gules, a lion passant guardant argent crowned or - Gerard de l'Ile - Dering Roll
ENAAAAEJ - or, a fess between two chevrons sable - Robert de l'Yle - Dering Roll
ENAAAAEK - azure, three keys or - William Chamberlein - Dering Roll
ENAAAAEL - argent, three lions passant azure - Geoffrey de Convile - Dering Roll
ENAAAAEM - gules, two keys crossed in saltire or - Philip Chamberlein - Dering Roll
ENAAAAEN - quarterly or and gules, a bordure azure - John Breton - Dering Roll
ENAAAAEO - argent, a lion rampant gules - Hugh de Torbevile - Dering Roll
ENAAAAEP - gules, three lions passant - Elis Giffard - Dering Roll
ENAAAAEQ - argent, two lions passant - John le Estrange - Dering Roll
ENAAAAER - barry dancetty argent and gules - John de Balun - Dering Roll
ENAAAAES - gules, two bars vair - Robert de Mortemer - Dering Roll
ENAAAAET - or, two ravens sable - Robert Corbet - Dering Roll
ENAAAAEU - gules, a chevron argent - Maurice de Berkley - Dering Roll
ENAAAAEV - bendy or and azure, a label gules - Rober de Munfort - Dering Roll
ENAAAAEW - argent, a lion rampant sable - Robert FitzRoger - Dering Roll
ENAAAAEX - paly or and gules, a canton ermine - Ralph Basset - Dering Roll
ENAAAAEY - argent, three cinquefoil gules - Norman Darci - Dering Roll
ENAAAAEZ - vair - John de Beauchamp - Dering Roll
ENAAAAEa - argent, a maunche gules - Ralph Toni - Dering Roll
ENAAAAEb - or, two bars gemelles and in chief a lion passant gules - John Tregoz - Dering Roll
ENAAAAEc - argent, a saltire gules - Maurice FitzGeroud - Dering Roll
ENAAAAEd - azure, three horse-brays or, on a chief ermine a demi-lion rampant gules - Geoffrey de Joinville - Dering Roll
ENAAAAEe - quarterly or and gules, a bordure vair - Richard FitzJohn - Dering Roll
ENAAAAEf - gules fretty or - William de Audele - Dering Roll
ENAAAAEg - argent, a sword sable - Philip Marmion - Dering Roll
ENAAAAEh - or fretty gules - Theobald de Verdon - Dering Roll
ENAAAAEi - chequy azure and or, a fess gules - Roger de Clifford - Dering Roll
ENAAAAEj - gules bezanty - Alan la Souche - Dering Roll
ENAAAAEk - gules, a fess indented argent - Ralph Daubeni - Dering Roll
ENAAAAEl - gules, a fess indented argent, in chief three mullets or - Philip Daubeni - Dering Roll
ENAAAAEm - gules, a fess indented and in chief three martlets argent - William Daubeni - Dering Roll
ENAAAAEn - gules, a fess indented between four escallops ermine - Robert Dinant - Dering Roll
ENAAAAEo - azure bezanty - William la Souche - Dering Roll
ENAAAAEp - gules, a fess indented ermine - Oliver Dinant - Dering Roll
ENAAAAEq - argent, on a fess sable bezants - Richard de Cornwall - Dering Roll
ENAAAAEr - gules crusilly or, a bend vair - Henry de Ralle - Dering Roll
ENAAAAEs - argent, three chevronels sable - Odo le Arcedekne - Dering Roll
ENAAAAEt - vairy argent and gules, a label sable bezanty - Robert de Aumari - Dering Roll
ENAAAAEu - sable, three buckles argent - Robert Malet - Dering Roll
ENAAAAEv - paly argent and gules, on a fess azure three bezants - Robert FitzNel - Dering Roll
ENAAAAEw - gules, a saltire argent within a bordure sable bezanty - Walter de la Pole - Dering Roll
ENAAAAEx - argent, a fess gules - Thomas de Kent - Dering Roll
ENAAAAEy - azure, a lion rampant or - Richard Pultimor - Dering Roll
ENAAAAEz - gules, a saltire vair - Henry de Chambemon - Dering Roll
ENAAAAE0 - or, on a cross sable five plates - Gilbert de Saint Alvin - Dering Roll
ENAAAAE1 - ermine, on a fess gules three bezants - Roger la Souche - Dering Roll
ENAAAAE2 - argent, a saltire indented gules - Robert Tipetot - Dering Roll
ENAAAAE3 - azure, a chief argent, a lion rampant gules - John de Joinville - Dering Roll
ENAAAAE4 - lozengy gules and vair - John de Borgh - Dering Roll
ENAAAAE5 - azure, a bend between six martlets or - Robert de Munteni - Dering Roll
ENAAAAE6 - gules, a saltire argent - Robert de Nevile - Dering Roll
ENAAAAE7 - chequy argent and gules - John de Vau - Dering Roll
ENAAAAE8 - argent, nine bars gules surmounted by a lion rampant sable - Robert de Estoteville - Dering Roll
ENAAAAE9 - gules, a lion rampant argent - Roger de Mumbray - Dering Roll
ENAAAAE+ - sable, a lion rampant argent - Nicole de Segrave - Dering Roll
ENAAAAE/ - gules crusilly or, a chevron or - Felipe de Kyme - Dering Roll
ENAAAAFA - barry argent and azure, a label gules - Reynold de Grey - Dering Roll
ENAAAAFB - or, a fess between two chevrons gules - Robert le FitzWater - Dering Roll
ENAAAAFC - argent, a fess between two chevrons gules - Gilbert Peche - Dering Roll
ENAAAAFD - barry argent and azure - Richard de Grey - Dering Roll
ENAAAAFE - gules, three water-bougets argent - Robert de Ros - Dering Roll
ENAAAAFF - argent, two abrs and a canton gules - John de Boys - Dering Roll
ENAAAAFG - azure, a lion rampant argent - ??? Mohaut - Dering Roll
ENAAAAFH - or, two lions passant azure - Roger de Sumeri - Dering Roll
ENAAAAFI - quarterly: first and fourth, argent; second and third, gules fretty or; a bend sable - Hugh le Despenser - Dering Roll
ENAAAAFJ - or, a cross sable - John de Veci - Dering Roll
ENAAAAFK - gules crusily and three pikes or - Geoffrey de Lusci - Dering Roll
ENAAAAFL - or, a maunch gules - John de Hastinge - Dering Roll
ENAAAAFM - gules, a cinquefoil argent - Robert de Quinci - Dering Roll
ENAAAAFN - gules, a saltire and a chief or - Richard de Brus - Dering Roll
ENAAAAFO - argent, two bars gemelles and on a chief gules a lion passant or - Osbarn Giffard - Dering Roll
ENAAAAFP - gules, three lions passant argent, a label azure - John Giffard - Dering Roll
ENAAAAFQ - barry wavy argent and azure - Simon Basset - Dering Roll
ENAAAAFR - barry or and azure - Henry de Panebregge - Dering Roll
ENAAAAFS - barry argent and gules - Robert Talbot - Dering Roll
ENAAAAFT - azure, three fleur-de-lis - John de Cantelo - Dering Roll
ENAAAAFU - argent, three bars gemelles sable surmounted by a lion rampant gules - Adam de Muhaut - Dering Roll
ENAAAAFV - azure, two chevrons or - Thomas de Chewurthe - Dering Roll
ENAAAAFW - barry or and gules - Brian FitzAlan - Dering Roll
ENAAAAFX - gules, three bends argent - Henry Mauvsin - Dering Roll
ENAAAAFY - paly or and azure, a fess gules - Henry de Borchelle - Dering Roll
ENAAAAFZ - gules, three lions rampant argent - Grimbald Pancevot - Dering Roll
ENAAAAFa - sable fretty or - John Mautravers - Dering Roll
ENAAAAFb - argent, a chevron between three mullets gules - Adam de Cretinge - Dering Roll
ENAAAAFc - sable fretty or, on a canton gules three lions passant argent - William Mautravers - Dering Roll
ENAAAAFd - or, a cross indented sable surmounted by a gurge azure - Robert Giffard - Dering Roll
ENAAAAFe - gules, three mullets or - Beves de Cnouvile - Dering Roll
ENAAAAFf - argent, three mullets gules - Gilbert de Cnouvile - Dering Roll
ENAAAAFg - gules, a bend indented or - John le Marescal - Dering Roll
ENAAAAFh - or, a saltire gules - John de Vautour - Dering Roll
ENAAAAFi - gules, three plates - Ralph Musard - Dering Roll
ENAAAAFj - argent, a fess between three escallops sable - Geoffrey de Languele - Dering Roll
ENAAAAFk - or, three stag heads sable - Walter de Helyon - Dering Roll
ENAAAAFl - per fess argent and gules, a lion rampant within a bordure gules counterchanged - Philip de Serne - Dering Roll
ENAAAAFm - argent, a chevron sable - William de Wautone - Dering Roll
ENAAAAFn - or, three dice sable each with a point argent - William Ambesas - Dering Roll
ENAAAAFo - argent, an oak tree gules - Roland de Okstede - Dering Roll
ENAAAAFp - quarterly or and azure, in first quarter a lion rampant gules - Ralph de Jarconvile - Dering Roll
ENAAAAFq - gules fretty vair - Thomas de Tichesie - Dering Roll
ENAAAAFr - azure, a chevron or - John de Aubernoun - Dering Roll
ENAAAAFs - gules, a saltire vair - Ralph de Wiltone - Dering Roll
ENAAAAFt - ermine, a chief indented gules - Anselm Basset - Dering Roll
ENAAAAFu - or, a fleur-de-lis gules - Adam Gordun - Dering Roll
ENAAAAFv - chequy gules and argent, a fess azure - Oliver de Tudham - Dering Roll
ENAAAAFw - gules billety and a fess or - John de Beauchamp - Dering Roll
ENAAAAFx - chequy gules and argent, a fess azure - Robert de Tudham - Dering Roll
ENAAAAFy - or, a bend gules - ??? - Dering Roll
ENAAAAFz - gules crusilly and a bend argent - Saer de Huntingfeld - Dering Roll
ENAAAAF0 - gules, a fess between six martlets or - Walter de Beauchamp - Dering Roll
ENAAAAF1 - gules crusilly and a bend or - William de Prestone - Dering Roll
ENAAAAF2 - paly argent and gules, a bend sable - Robert Eneby - Dering Roll
ENAAAAF3 - vairy argent and sable - Robert la Warde - Dering Roll
ENAAAAF4 - gules, two wolves passant argent - Nicholas le Leu - Dering Roll
ENAAAAF5 - or, three hedghogs statant sable - Henry de Herice - Dering Roll
ENAAAAF6 - quarterly argent and sable - Walter FitzHumphrey - Dering Roll
ENAAAAF7 - argent, three stockings gules - Nicholas de la Heuse - Dering Roll
ENAAAAF8 - gules, two pales or, on a canton argent a mullet sable - Richard de Welles - Dering Roll
ENAAAAF9 - argent, a stag head gules - Henry de Perk - Dering Roll
ENAAAAF+ - gules, a fess argent, a label or - William Mansel - Dering Roll
ENAAAAF/ - argent fretty gules - John de Stavertone - Dering Roll
ENAAAAGA - or, three chevronels gules, a chief vair - Herbert de Saint Quintin - Dering Roll
ENAAAAGB - quarterly per fess indented or and gules - Fulk FitzWarin - Dering Roll
ENAAAAGC - azure, two abrs vairy gules and ermine - Reynold de Breouse - Dering Roll
ENAAAAGD - argent, three bars gules - Theobald de Moletone - Dering Roll
ENAAAAGE - argent fretty and on a canton gules a lion passant or - Walter de Donstanvile - Dering Roll
ENAAAAGF - paly argent and azure, on a bend gules three escallops or - Othon de Grançon - Dering Roll
ENAAAAGG - argent, a fess and in chief two mullets gules - William d'Odingeseles - Dering Roll
ENAAAAGH - argent, two chevrons gules, a label azure - Lawrence de Saint Maur - Dering Roll
ENAAAAGI - sable crusilly and a bend indented argent - Robert de Witefeld - Dering Roll
ENAAAAGJ - gules, nine cocks argent - Henry de Cokyntone - Dering Roll
ENAAAAGK - sable billety and a bend argent - Baldwin Boliers - Dering Roll
ENAAAAGL - gules, six eagles displayed or - Ralph de Limeseye - Dering Roll
ENAAAAGM - azure, a saltire and a chief or - Ingram de Brus - Dering Roll
ENAAAAGN - gules, a lion rampant ermine - William de Neireford - Dering Roll
ENAAAAGO - argent, two chevrons sable - William de Lamborne - Dering Roll
ENAAAAGP - barry argent and azure, three lions rampant gules crowned or - Ralph de Wodeburch - Dering Roll
ENAAAAGQ - gules, three saltires argent - William de Bovile - Dering Roll
ENAAAAGR - gules, three bends argent, a label azure - James de Birum - Dering Roll
ENAAAAGS - argent, six eagles displayed sable - Ralph de Kirketone - Dering Roll
ENAAAAGT - or, a lion rampant gules crowned azure, a bordure semy of plates - Hameris Beices - Dering Roll
ENAAAAGU - gules, within an orle of cinquefoils or an inescutcheon argent - Godfrey de Baseines - Dering Roll
ENAAAAGV - gules, three buckles or - John Malet - Dering Roll
ENAAAAGW - barry argent and azure, a chief indented gules - Giles de Rocheford - Dering Roll
ENAAAAGX - or, a cross gules fretty argent between four eagles displayed azure - Theobald de Mareli - Dering Roll
ENAAAAGY - argent, a fess between six mullets gules - Anselm de l'Ile - Dering Roll
ENAAAAGZ - gules, three escutcheons or - Stefne de Muntjoye - Dering Roll
ENAAAAGa - lozengy argent and gules - William Crepin - Dering Roll
ENAAAAGb - azure, three bends or, a bordure gules semy of fleur-de-lis argent - Guy de la Roce - Dering Roll
ENAAAAGc - or, three hunting-horns in pale gules - William de Hornes - Dering Roll
ENAAAAGd - or, two bars sable, in chief a mullet gules - Geoffrey de Meremond - Dering Roll
ENAAAAGe - or, a lion rampant sable, a bordure indented gules - Baldwin de Flandres - Dering Roll
ENAAAAGf - azure, five bars argent, on a chief or a lion passant gules - Walram de Lucemborch - Dering Roll
ENAAAAGg - Bendy or and azure, a bourdure indented gules - Othan de Trasenie - Dering Roll
ENAAAAGh - gules, two sea-perch addorsed or - Ralph de Nele - Dering Roll
ENAAAAGi - azure, within an orle of escallops an inescutcheon argent - Walter de Tupigni - Dering Roll
ENAAAAGj - or, a bend azure - Matthew de Trie - Dering Roll
ENAAAAGk - azure, six torteaux and on a chief or a demi-lion rampant gules - Simon de Moloun - Dering Roll
ENAAAAGl - gules, a bend argent - ??? - Dering Roll
ENAAAAGm - argent, a lion rampant sable - William de Fienes - Dering Roll
ENAAAAGn - or, three mallets gules - Giles de Maili - Dering Roll
ENAAAAGo - gules, a chief ermine - Chastelein d'Aras - Dering Roll
ENAAAAGp - azure, a lion rampant or - William de Rode - Dering Roll
ENAAAAGq - or, an escutcheon gules - Conestable de Flandres - Dering Roll
ENAAAAGr - argent, a fess sable and in chief a lion passant gules - Roger de Rome - Dering Roll
ENAAAAGs - or, a chevron gules - John d'Escoreney - Dering Roll
ENAAAAGt - barry or and gules, a bend azure - Audenard - Dering Roll
ENAAAAGu - gules, three pallets vair, on a chief or a demi-fleur-de-lis sable - Gaucher de Bazoches - Dering Roll
ENAAAAGv - sable, on a chief argent a demi-fleur-de-lis gules - Alexander van Gent - Dering Roll
ENAAAAGw - chequy gules and argent, on a chief or a demi-lion rampant sable - Robert de la Bruere - Dering Roll
ENAAAAGx - or, two lions rampant addorsed gules - Giles de Wattripont - Dering Roll
ENAAAAGy - argent, a bend gules surmounted by a lion rampant azure - Pouilly - Dering Roll
ENAAAAGz - or, an escutcheon sable, a label gules - Sire de Corane - Dering Roll
ENAAAAG0 - azure, on a chief argent a lion passant gules - John de Betune - Dering Roll
ENAAAAG1 - gules, three axes or - Arnold III de Renty - Dering Roll
ENAAAAG2 - or, three lozenges sable, a chief paly gules and argent - Hendrick V van Boutersem - Dering Roll

== Caeverlock Roll ==

ENAAAAG3 - or, a lion rampant purpure - Henry de Lacy - Caeverlock Roll
ENAAAAG4 - or, a fess between two chevrons gules - Robert le FitzWalter - Caeverlock Roll
ENAAAAG5 - gules, a bend indented or - William Earl Marshal - Caeverlock Roll
ENAAAAG6 - azure, three conquefoils or - Hugh Bardolf - Caeverlock Roll
ENAAAAG7 - gules, crusilly and a chevron or - Philip de Kyme - Caeverlock Roll
ENAAAAG8 - barry argent and azure - Henry de Grey - Caeverlock Roll
ENAAAAG9 - azure, a lion rampant argent - Robert de Mohaut - Caeverlock Roll
ENAAAAG+ - argent, three bars gules - Thomas de Multon - Caeverlock Roll
ENAAAAG/ - argent, two bars and on a quarter gules a lion passant guardant or - John de Lancaster - Caeverlock Roll
ENAAAAHA - or, a fess dancetty sable - William le Vavasour - Caeverlock Roll
ENAAAAHB - gules fretty argent - John de Hoddelston - Caeverlock Roll
ENAAAAHC - quarterly or and gules, a bend sable - Robert le FitzRoger - Caeverlock Roll
ENAAAAHD - quarterly or and gules, a bend sable, a label vert - John de Clavering - Caeverlock Roll
ENAAAAHE - azure, a bend argent cotised between six lions rampant or - Humphrey de Bohun - Caeverlock Roll
ENAAAAHF - sable, a lion rampant argent crowned or, a label gules - Nicholas de Segrave - Caeverlock Roll
ENAAAAHG - sable, a lion rampant argent crowned or - John de Segrave - Caeverlock Roll
ENAAAAHH - chequy or and azure - John de Warenne - Caeverlock Roll
ENAAAAHI - or, a lion rampant azure - Henry de Percy - Caeverlock Roll
ENAAAAHJ - gules, three lions passant argent, a bend azure - Robert le FitzPayne - Caeverlock Roll
ENAAAAHK - chequy argent and gules - Walter de Moncy - Caeverlock Roll
ENAAAAHL - barruly argent and azure, an orle of martlets gules - Aymer de Valence - Caeverlock Roll
ENAAAAHM - or, three lions passant sable - Nicholas de Carew - Caeverlock Roll
ENAAAAHN - gules crusilly and a lion rampant argent - Roger de la Ware - Caeverlock Roll
ENAAAAHO - gules crusilly and a fess or - Guy de Beauchamp - Caeverlock Roll
ENAAAAHP - or, a cross engrailed sable - John de Mohun - Caeverlock Roll
ENAAAAHQ - chequy or and gules, a chief ermine - Robert de Tateshal - Caeverlock Roll
ENAAAAHR - barruly argent and azure, three chaplets gules - Ralph le FitzGuilleme - Caeverlock Roll
ENAAAAHS - gules, three water-bougets argent - William de Ros - Caeverlock Roll
ENAAAAHT - barry of eight or and agules - Hugh Pointz - Caeverlock Roll
ENAAAAHU - vair - John de Beauchamp - Caeverlock Roll
ENAAAAHV - gules, three lions passant guardant or - Edward I - Caeverlock Roll
ENAAAAHW - chequy or and azure, a bordure gules semy of lions passant guardant or, a quarter ermine - John of Brittany - Caeverlock Roll
ENAAAAHX - azure crusily and two sea-perch or, a bordure engrailed gules - John de Bar - Caeverlock Roll
ENAAAAHY - paly argent and azure, on a bend gules three eagles displayed or - William de Grandison - Caeverlock Roll
ENAAAAHZ - gules, a fess indented argent - Elie d'Aubigny - Caeverlock Roll
ENAAAAHa - gules - Amanieu d'Albret - Caeverlock Roll
ENAAAAHb - quarterly gules and or, in first quarter a mullet argent, a bordure engrailed sable - Hugh de Vere - Caeverlock Roll
ENAAAAHc - lozengy or and gules - John de Rivers - Caeverlock Roll
ENAAAAHd - lozengy or and gules - Maurice de Craon - Caeverlock Roll
ENAAAAHe - chequy or and azure, a fess gules - Robert de Clifford - Caeverlock Roll
ENAAAAHf - quarterly: first and fourth, argent; second and third, gules fretty or; a bend sable - Hugh le Despenser - Caeverlock Roll
ENAAAAHg - or, three torteaux, a label azure - Hugh de Courtenay - Caeverlock Roll
ENAAAAHh - or fretty and on a chief sable three bezants - Amauri de St Amand - Caeverlock Roll
ENAAAAHi - gules crusilly and a fess dancetty or - John de Engaine - Caeverlock Roll
ENAAAAHj - gules, a fess between six martlets or - Walter de Beauchamp - Caeverlock Roll
ENAAAAHk - or, a saltire engrailed sable - John Botetourt - Caeverlock Roll
ENAAAAHl - or, a cross engrailed gules - Eustace de Hache - Caeverlock Roll
ENAAAAHm - or, a lion rampant queued fourchy sable - Adam de Welles - Caeverlock Roll
ENAAAAHn - gules, six escallops argent - Robert de Scales - Caeverlock Roll
ENAAAAHo - gules, semy of martlets or - William Thoucet - Caeverlock Roll
ENAAAAHp - gules, a lion rampant within a bordure argent semy of roses proper - Patrick de Dunbar - Caeverlock Roll
ENAAAAHq - gules, a lion rampant within a bordure argent semy of roses proper, a label azure - Patrick de Dunbar (Jr) - Caeverlock Roll
ENAAAAHr - sable, a cross flory argent - Richard Siward - Caeverlock Roll
ENAAAAHs - sable, six roses argent - Simon Fraser - Caeverlock Roll
ENAAAAHt - barry or and gules - Brian le FitzAlan - Caeverlock Roll
ENAAAAHu - or, six lions rampant queued fourchy azure - Roger de Morteyn - Caeverlock Roll
ENAAAAHv - ermine, two bars gemelles gules - Walter de Huntercombe - Caeverlock Roll
ENAAAAHw - azure, three crescents or - William de Rithre - Caeverlock Roll
ENAAAAHx - argent, a bend between six martlets gules - Thomas de Furnival - Caeverlock Roll
ENAAAAHy - gules, a maunch argent - John de la Mare - Caeverlock Roll
ENAAAAHz - gules, two lions passant argent - John le Strange - Caeverlock Roll
ENAAAAH0 - barry argent and azure, a bend indented gules - John de Grey - Caeverlock Roll
ENAAAAH1 - gules, a fess vair between three leopard heads jessant-de-lis or - William de Cauntelo - Caeverlock Roll
ENAAAAH2 - gules, two bars vair - Hugh de Mortimer - Caeverlock Roll
ENAAAAH3 - argent, a griffin segreant or - Simon de Montagu - Caeverlock Roll
ENAAAAH4 - gules, three lions passant guardant or, a label azure - Edward of Caernavon - Caeverlock Roll
ENAAAAH5 - argent, on a chief gules two mullets or - John de St John - Caeverlock Roll
ENAAAAH6 - argent, a maunch gules - Robert de Tony - Caeverlock Roll
ENAAAAH7 - argent, a chevron gules - Henry le Tyes - Caeverlock Roll
ENAAAAH8 - gules, a cross patty or - William le Latimer - Caeverlock Roll
ENAAAAH9 - azure, six lions rampant argent - William de Leyburn - Caeverlock Roll
ENAAAAH+ - barry, a chief paly, the corners gyronny, or and azure, an inescutcheon ermine - Roger de Mortimer - Caeverlock Roll *
ENAAAAH/ - gules, three lions passant guardant or, a label azure charged with nine fleur-de-lis or - Thomas of Lancaster - Caeverlock Roll
ENAAAAIA - gules, three lions passant guardant or, a bend azure - Henry de Lancaster - Caeverlock Roll
ENAAAAIB - gules, seven mascles or - William de Ferrers - Caeverlock Roll
ENAAAAIC - or, three chevronels gules - Joan of Acre - Caeverlock Roll
ENAAAAID - or, an eagle displayed vert - Ralph de Monthermer - Caeverlock Roll
ENAAAAIE - vairy argent and sable - Robert de la Ward - Caeverlock Roll
ENAAAAIF - argent, on a chief gules two mullets or, a label azure - John de St John (Jr) - Caeverlock Roll
ENAAAAIG - gules, a lion rampant or - Richard FitzAlan - Caeverlock Roll
ENAAAAIH - gules bezanty - Alan la Zouche - Caeverlock Roll
ENAAAAII - gules, a cross moline ermine - Anthony Bek - Caeverlock Roll
ENAAAAIJ - or, a maunch gules - John de Hastings - Caeverlock Roll
ENAAAAIK - or, a maunch gules, a label sable - Edmund de Hastings - Caeverlock Roll
ENAAAAIL - vert, a maunch or - John Paynel - Caeverlock Roll
ENAAAAIM - azure billety, a fess dancetty or - Edmund Deincourt - Caeverlock Roll
ENAAAAIN - gules, a fess between three popinjays argent - John le FitzMarmaduke - Caeverlock Roll
ENAAAAIO - gules crusilly, a chevron argent, a label azure - Maurice de Berkeley - Caeverlock Roll
ENAAAAIP - argent, an orle gules - Alexander de Balliol - Caeverlock Roll
ENAAAAIQ - argent, three pitchers gules, a bordure sable bezanty - Bertrand de Montbourcher - Caeverlock Roll
ENAAAAIR - vair - Gerard de Gondreville - Caeverlock Roll
ENAAAAIS - or fretty azure - Robert de Willoughby - Caeverlock Roll
ENAAAAIT - gules, three mullets argent - Robert de Hamsart - Caeverlock Roll
ENAAAAIU - gules, a saltire, on a chief argent three escallops gules - Henry de Graham - Caeverlock Roll
ENAAAAIV - gules, two bars gemelles, a chief or - Thomas de Richmond - Caeverlock Roll
ENAAAAIW - lozengy or and azure - Ralph de Gorges - Caeverlock Roll
ENAAAAIX - lozengy gules and ermine - Richard de Rokley - Caeverlock Roll
ENAAAAIY - azure, three lions rampant crowned or - Adam de la Ford - Caeverlock Roll
ENAAAAIZ - sable, three mullets, a bordure engrailed or - John de Wigton - Caeverlock Roll
ENAAAAIa - argent, a cross engrailed vert - Richard de Kirkbride - Caeverlock Roll
ENAAAAIb - argent, a fess double cotised gules, a label azure - Bartholomew de Badlesmere - Caeverlock Roll
ENAAAAIc - azure, a lion rampant queued fourchy argent crowned or - John de Cronwell - Caeverlock Roll
ENAAAAId - argent, a chevron between three mullets gules - John de Creting - Caeverlock Roll
ENAAAAIe - azure billety, a fess dancetty or - John Deincourt - Caeverlock Roll
ENAAAAIf - ermine, on a chief indented gules three mullets or - John Basset - Caeverlock Roll
ENAAAAIg - ermine, on a chief indented gules three escallops or - Edmund Basset - Caeverlock Roll
ENAAAAIh -  -  - Caeverlock Roll
ENAAAAIi -  -  - Caeverlock Roll
ENAAAAIj -  -  - Caeverlock Roll
ENAAAAIk -  -  - Caeverlock Roll
ENAAAAIl -  -  - Caeverlock Roll
ENAAAAIm -  -  - Caeverlock Roll
ENAAAAIn -  -  - Caeverlock Roll
ENAAAAIo -  -  - Caeverlock Roll
ENAAAAIp -  -  - Caeverlock Roll
ENAAAAIq -  -  - Caeverlock Roll
ENAAAAIr -  -  - Caeverlock Roll
ENAAAAIs -  -  - Caeverlock Roll
ENAAAAIt -  -  - Caeverlock Roll
ENAAAAIu -  -  - Caeverlock Roll
ENAAAAIv -  -  - Caeverlock Roll
ENAAAAIw -  -  - Caeverlock Roll
ENAAAAIx -  -  - Caeverlock Roll
ENAAAAIy -  -  - Caeverlock Roll
ENAAAAIz -  -  - Caeverlock Roll
ENAAAAI0 -  -  - Caeverlock Roll
ENAAAAI1 -  -  - Caeverlock Roll
ENAAAAI2 -  -  - Caeverlock Roll
ENAAAAI3 -  -  - Caeverlock Roll
ENAAAAI4 -  -  - Caeverlock Roll
ENAAAAI5 -  -  - Caeverlock Roll
ENAAAAI6 -  -  - Caeverlock Roll
ENAAAAI7 -  -  - Caeverlock Roll
ENAAAAI8 -  -  - Caeverlock Roll
ENAAAAI9 -  -  - Caeverlock Roll
ENAAAAI+ -  -  - Caeverlock Roll
ENAAAAI/ -  -  - Caeverlock Roll
ENAAAAJA -  -  - Caeverlock Roll
ENAAAAJB -  -  - Caeverlock Roll
ENAAAAJC -  -  - Caeverlock Roll
ENAAAAJD -  -  - Caeverlock Roll
ENAAAAJE -  -  - Caeverlock Roll
ENAAAAJF -  -  - Caeverlock Roll
ENAAAAJG -  -  - Caeverlock Roll
ENAAAAJH -  -  - Caeverlock Roll
ENAAAAJI -  -  - Caeverlock Roll
ENAAAAJJ -  -  - Caeverlock Roll
ENAAAAJK -  -  - Caeverlock Roll
ENAAAAJL -  -  - Caeverlock Roll
ENAAAAJM -  -  - Caeverlock Roll
ENAAAAJN -  -  - Caeverlock Roll
ENAAAAJO -  -  - Caeverlock Roll
ENAAAAJP -  -  - Caeverlock Roll
ENAAAAJQ -  -  - Caeverlock Roll
ENAAAAJR -  -  - Caeverlock Roll
ENAAAAJS -  -  - Caeverlock Roll
ENAAAAJT -  -  - Caeverlock Roll
ENAAAAJU -  -  - Caeverlock Roll
ENAAAAJV -  -  - Caeverlock Roll
ENAAAAJW -  -  - Caeverlock Roll
ENAAAAJX -  -  - Caeverlock Roll
ENAAAAJY -  -  - Caeverlock Roll
ENAAAAJZ -  -  - Caeverlock Roll
ENAAAAJa -  -  - Caeverlock Roll
ENAAAAJb -  -  - Caeverlock Roll
ENAAAAJc -  -  - Caeverlock Roll
ENAAAAJd -  -  - Caeverlock Roll
ENAAAAJe -  -  - Caeverlock Roll
ENAAAAJf -  -  - Caeverlock Roll
ENAAAAJg -  -  - Caeverlock Roll
ENAAAAJh -  -  - Caeverlock Roll
ENAAAAJi -  -  - Caeverlock Roll
ENAAAAJj -  -  - Caeverlock Roll
ENAAAAJk -  -  - Caeverlock Roll
ENAAAAJl -  -  - Caeverlock Roll
ENAAAAJm -  -  - Caeverlock Roll
ENAAAAJn -  -  - Caeverlock Roll
ENAAAAJo -  -  - Caeverlock Roll
ENAAAAJp -  -  - Caeverlock Roll
ENAAAAJq -  -  - Caeverlock Roll
ENAAAAJr -  -  - Caeverlock Roll
ENAAAAJs -  -  - Caeverlock Roll
ENAAAAJt -  -  - Caeverlock Roll
ENAAAAJu -  -  - Caeverlock Roll
ENAAAAJv -  -  - Caeverlock Roll
ENAAAAJw -  -  - Caeverlock Roll
ENAAAAJx -  -  - Caeverlock Roll
ENAAAAJy -  -  - Caeverlock Roll
ENAAAAJz -  -  - Caeverlock Roll
ENAAAAJ0 -  -  - Caeverlock Roll
ENAAAAJ1 -  -  - Caeverlock Roll
ENAAAAJ2 -  -  - Caeverlock Roll
ENAAAAJ3 -  -  - Caeverlock Roll
ENAAAAJ4 -  -  - Caeverlock Roll
ENAAAAJ5 -  -  - Caeverlock Roll
ENAAAAJ6 -  -  - Caeverlock Roll
ENAAAAJ7 -  -  - Caeverlock Roll
ENAAAAJ8 -  -  - Caeverlock Roll
ENAAAAJ9 -  -  - Caeverlock Roll
ENAAAAJ+ -  -  - Caeverlock Roll
ENAAAAJ/ -  -  - Caeverlock Roll
ENAAAAKA -  -  - Caeverlock Roll
ENAAAAKB -  -  - Caeverlock Roll
ENAAAAKC -  -  - Caeverlock Roll
ENAAAAKD -  -  - Caeverlock Roll
ENAAAAKE -  -  - Caeverlock Roll
ENAAAAKF -  -  - Caeverlock Roll
ENAAAAKG -  -  - Caeverlock Roll
ENAAAAKH -  -  - Caeverlock Roll
ENAAAAKI -  -  - Caeverlock Roll
ENAAAAKJ -  -  - Caeverlock Roll
ENAAAAKK -  -  - Caeverlock Roll
ENAAAAKL -  -  - Caeverlock Roll
ENAAAAKM -  -  - Caeverlock Roll
ENAAAAKN -  -  - Caeverlock Roll
ENAAAAKO -  -  - Caeverlock Roll
ENAAAAKP -  -  - Caeverlock Roll
ENAAAAKQ -  -  - Caeverlock Roll
ENAAAAKR -  -  - Caeverlock Roll
ENAAAAKS -  -  - Caeverlock Roll
ENAAAAKT -  -  - Caeverlock Roll
ENAAAAKU -  -  - Caeverlock Roll
ENAAAAKV -  -  - Caeverlock Roll
ENAAAAKW -  -  - Caeverlock Roll
ENAAAAKX -  -  - Caeverlock Roll
ENAAAAKY -  -  - Caeverlock Roll
ENAAAAKZ -  -  - Caeverlock Roll
ENAAAAKa -  -  - Caeverlock Roll
ENAAAAKb -  -  - Caeverlock Roll
ENAAAAKc -  -  - Caeverlock Roll
ENAAAAKd -  -  - Caeverlock Roll
ENAAAAKe -  -  - Caeverlock Roll
ENAAAAKf -  -  - Caeverlock Roll
ENAAAAKg -  -  - Caeverlock Roll
ENAAAAKh -  -  - Caeverlock Roll
ENAAAAKi -  -  - Caeverlock Roll
ENAAAAKj -  -  - Caeverlock Roll
ENAAAAKk -  -  - Caeverlock Roll
ENAAAAKl -  -  - Caeverlock Roll
ENAAAAKm -  -  - Caeverlock Roll
ENAAAAKn -  -  - Caeverlock Roll
ENAAAAKo -  -  - Caeverlock Roll
ENAAAAKp -  -  - Caeverlock Roll
ENAAAAKq -  -  - Caeverlock Roll
ENAAAAKr -  -  - Caeverlock Roll
ENAAAAKs -  -  - Caeverlock Roll
ENAAAAKt -  -  - Caeverlock Roll
ENAAAAKu -  -  - Caeverlock Roll
ENAAAAKv -  -  - Caeverlock Roll
ENAAAAKw -  -  - Caeverlock Roll
ENAAAAKx -  -  - Caeverlock Roll
ENAAAAKy -  -  - Caeverlock Roll
ENAAAAKz -  -  - Caeverlock Roll
ENAAAAK0 -  -  - Caeverlock Roll
ENAAAAK1 -  -  - Caeverlock Roll
ENAAAAK2 -  -  - Caeverlock Roll
ENAAAAK3 -  -  - Caeverlock Roll
ENAAAAK4 -  -  - Caeverlock Roll
ENAAAAK5 -  -  - Caeverlock Roll
ENAAAAK6 -  -  - Caeverlock Roll
ENAAAAK7 -  -  - Caeverlock Roll
ENAAAAK8 -  -  - Caeverlock Roll
ENAAAAK9 -  -  - Caeverlock Roll
ENAAAAK+ -  -  - Caeverlock Roll
ENAAAAK/ -  -  - Caeverlock Roll
ENAAAALA -  -  - Caeverlock Roll
ENAAAALB -  -  - Caeverlock Roll
ENAAAALC -  -  - Caeverlock Roll
ENAAAALD -  -  - Caeverlock Roll
ENAAAALE -  -  - Caeverlock Roll
ENAAAALF -  -  - Caeverlock Roll
ENAAAALG -  -  - Caeverlock Roll
ENAAAALH -  -  - Caeverlock Roll
ENAAAALI -  -  - Caeverlock Roll
ENAAAALJ -  -  - Caeverlock Roll
ENAAAALK -  -  - Caeverlock Roll
ENAAAALL -  -  - Caeverlock Roll
ENAAAALM -  -  - Caeverlock Roll
ENAAAALN -  -  - Caeverlock Roll
ENAAAALO -  -  - Caeverlock Roll
ENAAAALP -  -  - Caeverlock Roll
ENAAAALQ -  -  - Caeverlock Roll
ENAAAALR -  -  - Caeverlock Roll
ENAAAALS -  -  - Caeverlock Roll
ENAAAALT -  -  - Caeverlock Roll
ENAAAALU -  -  - Caeverlock Roll
ENAAAALV -  -  - Caeverlock Roll
ENAAAALW -  -  - Caeverlock Roll
ENAAAALX -  -  - Caeverlock Roll
ENAAAALY -  -  - Caeverlock Roll
ENAAAALZ -  -  - Caeverlock Roll
ENAAAALa -  -  - Caeverlock Roll
ENAAAALb -  -  - Caeverlock Roll
ENAAAALc -  -  - Caeverlock Roll
ENAAAALd -  -  - Caeverlock Roll
ENAAAALe -  -  - Caeverlock Roll
ENAAAALf -  -  - Caeverlock Roll
ENAAAALg -  -  - Caeverlock Roll
ENAAAALh -  -  - Caeverlock Roll
ENAAAALi -  -  - Caeverlock Roll
ENAAAALj -  -  - Caeverlock Roll
ENAAAALk -  -  - Caeverlock Roll
ENAAAALl -  -  - Caeverlock Roll
ENAAAALm -  -  - Caeverlock Roll
ENAAAALn -  -  - Caeverlock Roll
ENAAAALo -  -  - Caeverlock Roll
ENAAAALp -  -  - Caeverlock Roll
ENAAAALq -  -  - Caeverlock Roll
ENAAAALr -  -  - Caeverlock Roll
ENAAAALs -  -  - Caeverlock Roll
ENAAAALt -  -  - Caeverlock Roll
ENAAAALu -  -  - Caeverlock Roll
ENAAAALv -  -  - Caeverlock Roll
ENAAAALw -  -  - Caeverlock Roll
ENAAAALx -  -  - Caeverlock Roll
ENAAAALy -  -  - Caeverlock Roll
ENAAAALz -  -  - Caeverlock Roll
ENAAAAL0 -  -  - Caeverlock Roll
ENAAAAL1 -  -  - Caeverlock Roll
ENAAAAL2 -  -  - Caeverlock Roll
ENAAAAL3 -  -  - Caeverlock Roll
ENAAAAL4 -  -  - Caeverlock Roll
ENAAAAL5 -  -  - Caeverlock Roll
ENAAAAL6 -  -  - Caeverlock Roll
ENAAAAL7 -  -  - Caeverlock Roll
ENAAAAL8 -  -  - Caeverlock Roll
ENAAAAL9 -  -  - Caeverlock Roll
ENAAAAL+ -  -  - Caeverlock Roll
ENAAAAL/ -  -  - Caeverlock Roll

= Spanish =

== Armorial de los Condes ==

ESAAAAAA - quarterly: first and fourth, or, four pallets gules; second and third, argent, a cross gules - Conte de Besalu - Armorial de los Condes
ESAAAAAB - gules, a wall with five arrowed embattlements argent - Vesconte de Vilamur - Armorial de los Condes !
ESAAAAAC - argent, two bends chequy or and gules - Vesconte de Alquerforadat - Armorial de los Condes
ESAAAAAD - vairy gules and argent - Conte de Terragona - Armorial de los Condes
ESAAAAAE - argent, on two fesses azure six fleur-de-lis or - Conte de Rossello - Armorial de los Condes
ESAAAAAF - per saltire: first and fourth, or, four pallets gules; second and third, argent, a cross gules - Conte de Cerdanya - Armorial de los Condes
ESAAAAAG - barry or and gules - Conte de Empuries - Armorial de los Condes
ESAAAAAH - argent, a stag trippant gules - Conte de Cervera - Armorial de los Condes
ESAAAAAI - or, a double-headed eagle sable crowned or, on an inescutcheon gules three logs bendwise or - Conte de Pallas - Armorial de los Condes
ESAAAAAJ - or, within a bordure compony or and sable a goat passant sable - Vesconte de Cabrera - Armorial de los Condes
ESAAAAAK - sable, a bell argent - Baro de Montclos - Armorial de los Condes !
ESAAAAAL - chequy or and azure - Vesconte de Castellnou - Armorial de los Condes
ESAAAAAM - gules, three pallets or - Vesconte de Rocaberti - Armorial de los Condes
ESAAAAAN - or, on three chevronels gules fifteen plates - Vesconte de Bas - Armorial de los Condes
ESAAAAAO - quarterly argent and gules - Vesconte de Escornalbou - Armorial de los Condes
ESAAAAAP - per saltire: first and fourth, or, four pallets gules; second and third, gules, three thistles(?) or - Vesconte de Cardona - Armorial de los Condes !
ESAAAAAQ - argent, on a fess sable five lozenges or - Vesconte de Ager - Armorial de los Condes
ESAAAAAR - gules, on a fess argent three hurts - Vervesor de Veg - Armorial de los Condes !
ESAAAAAS - or, two bulls passant sable armed, unguled, and pizzled gules - Vervesor de Toralla - Armorial de los Condes
ESAAAAAT - sable, within a bordure gules charged with eight fleur-de-lis or a lion salient argent armed, langued, and pizzled gules - Vervesor de Foya - Armorial de los Condes
ESAAAAAU - sable, three pallets argent - Vervesor de Besora - Armorial de los Condes
ESAAAAAV - gules, a doe trippant argent - Vervesor de Boxedos - Armorial de los Condes
ESAAAAAW - argent, two fesses azure - Vervesor de Gurmeja - Armorial de los Condes !
ESAAAAAX - per saltire: first and fourth, or, four pallets gules; second and third, chequy or and sable - Conte de Urgell - Armorial de los Condes
ESAAAAAY - or, four pallets gules, an inescutcheon argent - Conte de Osona - Armorial de los Condes !
ESAAAAAZ - barry wavy of eight argent and azure - Vervesor de Mediona - Armorial de los Condes
ESAAAAAa - barry or and sable - Vervesor de Montsrut - Armorial de los Condes !
ESAAAAAb - quarterly: first and fourth, gules, a cross flory argent; second and third, argent, three bars azure - Vervesor de Valademay - Armorial de los Condes !
ESAAAAAc - barry or and gules - Baro de Santa Pace - Armorial de los Condes !
ESAAAAAd - lozengy or and gules - Baro de Senelles - Armorial de los Condes !
ESAAAAAe - or, a goat rampant gules armed, unguled, and collared azure - Baro de Bellera - Armorial de los Condes
ESAAAAAf - gules, a doe trippant or/proper - Baro de Ceruia - Armorial de los Condes !
ESAAAAAg - azure, a lion salient or armed and langued gules - Baro de Canet - Armorial de los Condes !
ESAAAAAh - bendy argent and gules, on a chief argent three roses gules - Baro de Ves - Armorial de los Condes
ESAAAAAi - or, five birds to dexter in saltire gules armed azure - Baro de Termens - Armorial de los Condes !
ESAAAAAj - quarterly: first and fourth, azure, a castle or; second and third, or, a griffin segreant azure armed, beaked, and pizzled gules - Baro de Castellet - Armorial de los Condes
ESAAAAAk - gules, eight bezants in two columns - Baro de Montcada - Armorial de los Condes !
ESAAAAAl - or, within a bordure gules three pinecones argent - Pinos - Armorial de los Condes !
ESAAAAAm - or, a stag trippant azure - Cervello - Armorial de los Condes 
ESAAAAAn - barry of eight or and sable - Anglesola - Armorial de los Condes
ESAAAAAo - or, a double-headed eagle sable crowned or, on an inescutcheon gules three logs bendwise or - Mataplana - Armorial de los Condes
ESAAAAAp - argent, three wings gules - Alamany - Armorial de los Condes
ESAAAAAq - argent, a lion salient gules crowned or - Erill - Armorial de los Condes
ESAAAAAr - or, a lion salient azure armed and langued gules - Ribelles - Armorial de los Condes
ESAAAAAs - 
ESAAAAAt - 
ESAAAAAu - 
ESAAAAAv - 
ESAAAAAw - 
ESAAAAAx - 
ESAAAAAy - 
ESAAAAAz - 
ESAAAAA0 - 
ESAAAAA1 - 
ESAAAAA2 - 
ESAAAAA3 - 
ESAAAAA4 - 
ESAAAAA5 - 
ESAAAAA6 - 
ESAAAAA7 - 
ESAAAAA8 - 
ESAAAAA9 - 
ESAAAAA+ - 
ESAAAAA/ - 

= French =

== Armorial de l'Ost de Flandre ==

FRAAAAAA - azure semy-de-lis or - Phillipe le Bel - Armorial de l'Ost de Flandre
FRAAAAAB - azure semy-de-lis or, a bordure gules - Charles de Valois - Armorial de l'Ost de Flandre
FRAAAAAC - azure semy-de-lis or, a bendlet compony argent and gules - Louis de France - Armorial de l'Ost de Flandre
FRAAAAAD - azure semy-de-lis or, on a bendlet gules a mullet of six pierced argent in canton - Louis de Clermont - Armorial de l'Ost de Flandre
FRAAAAAE - azure semy-de-lis or, a label gules, a quarter ermine - Raymond Berenger d'Anjou - Armorial de l'Ost de Flandre
FRAAAAAF - or, four pallets gules, a bordure azure semy-de-lis or - Sanchez di Aragon - Armorial de l'Ost de Flandre
FRAAAAAG - azure semy-de-lis or, a label gules semy of castles or - Robert II d'Artois - Armorial de l'Ost de Flandre
FRAAAAAH - azure semy-de-lis or, a label gules semy of plates or - Philippe d'Artois - Armorial de l'Ost de Flandre
FRAAAAAI - gules, three pallets vair, a chief or, a label azure - Guy III de Chatillon - Armorial de l'Ost de Flandre
FRAAAAAJ - gules, three pallets vair, on a chief or a demi-fleur-de-lis sable - Jacques de Chatillon - Armorial de l'Ost de Flandre
FRAAAAAK - azure billety, a lion rampant or - Otton IV de Chalon - Armorial de l'Ost de Flandre
FRAAAAAL - bendy or and azure, a bordure gules - Robert II de Bourgogne - Armorial de l'Ost de Flandre
FRAAAAAM - chequy or and azure, a bordure gules, a quarter ermine - Jean II de Dreux - Armorial de l'Ost de Flandre
FRAAAAAN - chequy or and azure, a bordure engrailed gules, a quarter ermine - Arthur II de Bretagne - Armorial de l'Ost de Flandre
FRAAAAAO -  chequy or and azure, a bordure gules semy of plates, a quarter ermine - Pierre de Bretagne - Armorial de l'Ost de Flandre
FRAAAAAP - or, a lion rampant azure - Jean IV de Pierrepont - Armorial de l'Ost de Flandre
FRAAAAAQ - sable, a lion rampant or - Jean II d'Avesnes - Armorial de l'Ost de Flandre
FRAAAAAR - azure billety, a lion rampant or - Jean II de Brienne - Armorial de l'Ost de Flandre
FRAAAAAS - or, a gonfanon gules - Robert VI d'Auvergne - Armorial de l'Ost de Flandre
FRAAAAAT - or, a gonfanon gules, a bendlet azure - Geoffrey de Boulogne - Armorial de l'Ost de Flandre
FRAAAAAU - azure, three bend or, a bordure gules - Jean de Ponthieu - Armorial de l'Ost de Flandre
FRAAAAAV - chequy or and azure, a bordure gules - Jean II de Dreux - Armorial de l'Ost de Flandre
FRAAAAAW - chequy or and azure, on a bordure gules a lion rampant argent in canton - Robert II de Dreux - Armorial de l'Ost de Flandre
FRAAAAAX - chequy or and azure, a bordure engrailed gules - Robert II de Dreux-Beu - Armorial de l'Ost de Flandre
FRAAAAAY - barruly argent and azure - Hugues XIII de Lusignan - Armorial de l'Ost de Flandre
FRAAAAAZ - gules, on a bend or an escutcheon: bendy or and azure, a bordure gules - Guillaume III de Chalons - Armorial de l'Ost de Flandre
FRAAAAAa - gules, a dolphin or - Jean I de Forez - Armorial de l'Ost de Flandre
FRAAAAAb - azure, a bend or cotised argent - Etienne II de Sancerre - Armorial de l'Ost de Flandre
FRAAAAAc - paly argent and azure, a fess or - Musciato Guido dei Francheschi - Armorial de l'Ost de Flandre
FRAAAAAd - or, between sixteen alerions displayed azure a cross gules - Mathieu IV de Montmorency - Armorial de l'Ost de Flandre
FRAAAAAe - azure, seven bezants, a chief or - Adam IV de Melun - Armorial de l'Ost de Flandre
FRAAAAAf - azure, seven bezants, on a chief or three martlets gules - Simon de Melun - Armorial de l'Ost de Flandre
FRAAAAAg - or, between four alerions displayed azure a cross gules - Bourchard de Marly - Armorial de l'Ost de Flandre
FRAAAAAh - sable, a lion rampant queued fourchy argent - Amaury III de Meulan - Armorial de l'Ost de Flandre
FRAAAAAi - barry indented argent and gules alternatingly - Guillaume V de Crespin - Armorial de l'Ost de Flandre *
FRAAAAAj - barry indented argent and gules alternatingly, a label azure - Guillaume VI de Crespin - Armorial de l'Ost de Flandre *
FRAAAAAk - barry indented argent and gules alternatingly, a quarter or - Jean de Crespin - Armorial de l'Ost de Flandre
FRAAAAAl - argent, within an orle of seven martlets a fess gules - Anceau IV de l'Isle-Adam - Armorial de l'Ost de Flandre
FRAAAAAm - argent, within an orle of seven martlets a fess gules, a label azure - Jean de l'Isle-Adam - Armorial de l'Ost de Flandre
FRAAAAAn - argent, between four lions rampant azure a cross gules - Anseau de Chevreuse - Armorial de l'Ost de Flandre
FRAAAAAo - quarterly or and gules - Guy de Bouteiller de Senlis - Armorial de l'Ost de Flandre
FRAAAAAp - quarterly or and gules, a label azure - Anseau Bouteiller de Senlis - Armorial de l'Ost de Flandre
FRAAAAAq - azure billety, a cross or - Jean de Choiseul - Armorial de l'Ost de Flandre
FRAAAAAr - sable semy-de-lis or, a bend azure - Anseau de Choisel - Armorial de l'Ost de Flandre
FRAAAAAs - azure, a bend or - Mathieu de Trie - Armorial de l'Ost de Flandre
FRAAAAAt - or, a bend compony argent and azure - Renaud de Trie - Armorial de l'Ost de Flandre
FRAAAAAu - gules, three escallops or - Pierre V de Chambly - Armorial de l'Ost de Flandre
FRAAAAAv - gules, three escallops or, a label sable - Pierre VI de Chambly - Armorial de l'Ost de Flandre
FRAAAAAw - gules, three escallops or, a lable vert - Oudart de Chambly - Armorial de l'Ost de Flandre
FRAAAAAx - azure, three escallops or - Pierre de Machaut - Armorial de l'Ost de Flandre
FRAAAAAy - or, a lion passant, a bordure sable - Raoul de Soissons - Armorial de l'Ost de Flandre
FRAAAAAz - or, five bendlets azure, a bordure gules - Guy de la Roche-Guyon - Armorial de l'Ost de Flandre
FRAAAAA0 - barry argent and azure, in canton a martlet sable, a bordure gules - Renaud de Trie - Armorial de l'Ost de Flandre
FRAAAAA1 - gules, ten lozenges argent, a lable azure bezanty - Simon de Lalaing - Armorial de l'Ost de Flandre
FRAAAAA2 - or, three chevronels gules - Guillaume d'Ivry - Armorial de l'Ost de Flandre
FRAAAAA3 - or, between sixteen alerions displayed azure and on a cross gules five escallops argent  - Guy IX de Laval - Armorial de l'Ost de Flandre
FRAAAAA4 - barry wavy or and gules - Hardouin V de Maille - Armorial de l'Ost de Flandre
FRAAAAA5 - barry per pale counterchanged, a chief paly, the corners gyronny, or and azure, an inescutcheon argent - Renaud III de Pressigny - Armorial de l'Ost de Flandre *
FRAAAAA6 - or, a lion passant, a bordure sable - Raoul de Soissons - Armorial de l'Ost de Flandre
FRAAAAA7 - azure, three horse-brays or, on a chief ermine a demi-lion rampant gules crowned or - Jean de Joinville - Armorial de l'Ost de Flandre
FRAAAAA8 - gules trefly, two barbels addorsed or - Raoul II de Clermont - Armorial de l'Ost de Flandre
FRAAAAA9 - or trefly, two barbels addorsed gules - Guy de Nesle - Armorial de l'Ost de Flandre
FRAAAAA+ - barry argent and azure, a bordure gules - Jean de Picquigny - Armorial de l'Ost de Flandre
FRAAAAA/ - barry argent and azure, a bordure gules bezanty - Renaud de Picquigny - Armorial de l'Ost de Flandre
FRAAAABA - gules, an orle ermine - Enguerrand de Bailleul - Armorial de l'Ost de Flandre
FRAAAABB - gules, a fess or - Piere de Bailleul - Armorial de l'Ost de Flandre
FRAAAABC - argent, three escutcheon gules - Gerard d'Abbeville - Armorial de l'Ost de Flandre
FRAAAABD - gules crusilly, three mullets or - Hugues de Caumont - Armorial de l'Ost de Flandre
FRAAAABE - argent, on a cross gules five escallops or - Aubert IV de Hangest - Armorial de l'Ost de Flandre
FRAAAABF - or, on a cross gules five escallops argent - Adam de Cardonnoy - Armorial de l'Ost de Flandre
FRAAAABG - or, on a cross sable five escallops argent - Jean de Raineval - Armorial de l'Ost de Flandre
FRAAAABH - or, three lozenges gules, a label azure - Raoul VI de Flament - Armorial de l'Ost de Flandre
FRAAAABI - azure semy-de-lis or, a demi-lion rampant argent - Raoul VI de Flament - Armorial de l'Ost de Flandre
FRAAAABJ - argent, a chief gules - Thibaut de Pont Remy - Armorial de l'Ost de Flandre
FRAAAABK - ermine, a lion rampant gules crowned or - Guillaume de Beaussart - Armorial de l'Ost de Flandre
FRAAAABL - argent, a lion rampant sable crowned or - Baudouin de Hermelinghen - Armorial de l'Ost de Flandre
FRAAAABM - sable, a chief argent - Dreux de Milly - Armorial de l'Ost de Flandre
FRAAAABN - argent, a fess dancetty gules - Robert de Beauval - Armorial de l'Ost de Flandre
FRAAAABO - gules, a bend or - Jean de Maignelay - Armorial de l'Ost de Flandre
FRAAAABP - gules, a bend engrailed or - Jean II de Crequy - Armorial de l'Ost de Flandre
FRAAAABQ - gules, three pallets vair, on a chief or a lion passant gules - Gaucher de Chatillon-Autreches - Armorial de l'Ost de Flandre
FRAAAABR - or, three mallets gules - Simon de Mailly - Armorial de l'Ost de Flandre
FRAAAABS - or, an orle of eagles displayed gules - Eschivard de Preuilly - Armorial de l'Ost de Flandre
FRAAAABT - gules crusilly, a bend argent - Guillaume de Tyrel - Armorial de l'Ost de Flandre
FRAAAABU - argent, a cross gringoly gules headed or - Arnould de Cayeaux - Armorial de l'Ost de Flandre !
FRAAAABV - barry vair and gules - Enguerrand IV de Coucy - Armorial de l'Ost de Flandre
FRAAAABW - barry vair and gules, a quarter or - Robert II de Coucy - Armorial de l'Ost de Flandre
FRAAAABX - or, withn an orle of martlets two fesses gules - Dreux III de Mello - Armorial de l'Ost de Flandre
FRAAAABY - vert, a fess argent - Robert de Boisleux - Armorial de l'Ost de Flandre
FRAAAABZ - azure, a millrind/cross moline argent - Jean Sausset - Armorial de l'Ost de Flandre !
FRAAAABa - azure, an inescutcheon argent, a label gules - Robert de Wavrin - Armorial de l'Ost de Flandre
FRAAAABb - or, a lion rampant gules - Gibert de Bergues-Saint Winnoc - Armorial de l'Ost de Flandre
FRAAAABc - or, a fess gules - Jean de Haveskerke - Armorial de l'Ost de Flandre
FRAAAABd - or, a fess gules, a label azure - Gilles de Haveskerke - Armorial de l'Ost de Flandre
FRAAAABe - or, a lion rampant sable, a label gules - Godefroi de Brabant - Armorial de l'Ost de Flandre
FRAAAABf - argent, within an orle of horseshoes gules an inescutcheon - Jean de Ferrieres - Armorial de l'Ost de Flandre
FRAAAABg - argent, a chief gules, a lion rampant azure charged on the shoulder with a fleur-de-lis or - Godefroi de Vendome - Armorial de l'Ost de Flandre
FRAAAABh - gules, withing an orle of angennes or an inescutcheon argent - Robert de Tancarville - Armorial de l'Ost de Flandre
FRAAAABi - gyronny or and azure, an inescutcheon argent, a saltire ermine - Nicolas des Armoises - Armorial de l'Ost de Flandre
FRAAAABj - gules, three pallets vairy argent and vert, a chief or - Gobert III de Montchalons - Armorial de l'Ost de Flandre
FRAAAABk - or, a lion rampant vert - Robert VI Bertrand - Armorial de l'Ost de Flandre
FRAAAABl - ermine, a fess gules - Robert de Thibouville - Armorial de l'Ost de Flandre
FRAAAABm - gules, three buckles or - Jean II de Malet - Armorial de l'Ost de Flandre
FRAAAABn - or, three mallets gules - Guillaume III de Martel - Armorial de l'Ost de Flandre
FRAAAABo - paly or and azure, a chief gules - Gui d'Esneval - Armorial de l'Ost de Flandre
FRAAAABp - or, three chevronels gules - Galeran d'Ivry - Armorial de l'Ost de Flandre
FRAAAABq - chevronny or and gules - Pierre de Richebourg - Armorial de l'Ost de Flandre
FRAAAABr - or, three chevronels gules - Guillaume d'Ivry - Armorial de l'Ost de Flandre
FRAAAABs - gules, two fesses or - Jean II de Harcourt - Armorial de l'Ost de Flandre
FRAAAABt - gules, two fesses or, a label azure - Guillaume de Harcourt - Armorial de l'Ost de Flandre
FRAAAABu - gules bezanty, three cinquefoils argent - Raoul de Patry - Armorial de l'Ost de Flandre
FRAAAABv - gules, three cinquefoils argent - Foucault de Merle - Armorial de l'Ost de Flandre
FRAAAABw - argent, on a bend gules three eagles displayed or, a label azure - Jacques be Bayon - Armorial de l'Ost de Flandre
FRAAAABx - or, a key gules - Gui III de Thil-Chatel - Armorial de l'Ost de Flandre
FRAAAABy - or, three torteaux - Jean de Courtenay - Armorial de l'Ost de Flandre
FRAAAABz - or, three bars gemelles azure, a bordure gules - Mathieu II de Villebeon - Armorial de l'Ost de Flandre
FRAAAAB0 - argent, on a fess gules three annulets or - Hugues de Bouville - Armorial de l'Ost de Flandre
FRAAAAB1 - or, a lion rampant sable  - Herve V de Leon - Armorial de l'Ost de Flandre
FRAAAAB2 - or, a lion rampant sable, a bendlet gules - Herve VI de Leon - Armorial de l'Ost de Flandre
FRAAAAB3 - or, a lion rampant sable, a label gules - Richard de la Roche  - Armorial de l'Ost de Flandre
FRAAAAB4 - argent, a fess azure diapered or - Jean II de Cleres - Armorial de l'Ost de Flandre
FRAAAAB5 - or billety gules - Jean de Saint-Martin - Armorial de l'Ost de Flandre
FRAAAAB6 - gules, three fleur-de-lis argent - Arnould IV de Wesmael - Armorial de l'Ost de Flandre
FRAAAAB7 - or, a bend gules - Wauthier III de Ligne - Armorial de l'Ost de Flandre
FRAAAAB8 - or, three bendlets sable - Jean de Denisy - Armorial de l'Ost de Flandre
FRAAAAB9 - sable, seven bezants or, a chief paly or and gules - Jean de Chatelier - Armorial de l'Ost de Flandre
FRAAAAB+ - or, three escutcheons gules - Thiebaut IV de Mathefelon - Armorial de l'Ost de Flandre
FRAAAAB/ - azure semy-de-lis or, a demi-lion rampant argent - Jean de Beaumont - Armorial de l'Ost de Flandre
FRAAAACA - gules, a cross patoncy ermine - Hardouin de la Haye-Joulain - Armorial de l'Ost de Flandre
FRAAAACB - barruly argent and gules, an orle of martlets sable - Patrice II de Chourches - Armorial de l'Ost de Flandre
FRAAAACC - gules, three pallets vair, on a chief or two lions passant combatant gules - Jean de Chatillon-Bazoches - Armorial de l'Ost de Flandre
FRAAAACD - barry or and gules, a label azure semy of plates - Gerard de Looz - Armorial de l'Ost de Flandre
FRAAAACE - gules, an eagle displayed or - Pierre de Preaux - Armorial de l'Ost de Flandre
FRAAAACF - or, a fess gules - Jean de Bailleuil - Armorial de l'Ost de Flandre
FRAAAACG - or, between three torteaux a fess gules - Pierre de Corneuil - Armorial de l'Ost de Flandre
FRAAAACH - barruly or and azure, a lion rampant gules collared argent - Jean de Rouvray - Armorial de l'Ost de Flandre
FRAAAACI - paly or and gules - Pierre d'Amboise - Armorial de l'Ost de Flandre
FRAAAACJ - gules, a lion rampant or - Geoffroi de Savary - Armorial de l'Ost de Flandre
FRAAAACK - argent, a fess gules - Guillaume IV de Sainte-Maure - Armorial de l'Ost de Flandre
FRAAAACL - gules, three chevronels or - Yon de Garencieres - Armorial de l'Ost de Flandre
FRAAAACM - or billety, a lion rampant queued fourchy sable - Adam de Bruyeres - Armorial de l'Ost de Flandre
FRAAAACN - barry wavy or and gules - Hardouin VI de Maille - Armorial de l'Ost de Flandre
FRAAAACO - quarterly gules and vair - Eudes le Brun de Vernoil - Armorial de l'Ost de Flandre
FRAAAACP - or, an orle of martlets, a canton gules - Gui de Chemille - Armorial de l'Ost de Flandre
FRAAAACQ - or, within an orle of martlets two fesses sable - Guillaume V de Meslay - Armorial de l'Ost de Flandre
FRAAAACR - barry or and vert semy-de-lis counterchanged, a bendlet gules - Guillaume de Mortemer - Armorial de l'Ost de Flandre
FRAAAACS - azure semy of mullets or, a lion rampant argent - Nicolas Hotot - Armorial de l'Ost de Flandre
FRAAAACT - or, a millrind gules - Hugues IX de Baucay - Armorial de l'Ost de Flandre !
FRAAAACU - azure, between four mullets or a saltire argent - Godefroi d'Averton - Armorial de l'Ost de Flandre
FRAAAACV - azure trefly, a lion rampant or - Itier de Brion - Armorial de l'Ost de Flandre
FRAAAACW - gules, three escutcheons argent - Jean de Charny - Armorial de l'Ost de Flandre
FRAAAACX - gules, a rose argent - Enlart de Seninghem - Armorial de l'Ost de Flandre
FRAAAACY - per pale argent and gules, a cross clechy, pommetty and voided per pale gules and or - Guillaume Barasc de Bruniquel - Armorial de l'Ost de Flandre
FRAAAACZ - gyronny vair and gules - Maurice de Belleville - Armorial de l'Ost de Flandre
FRAAAACa - or fretty gules - Bruiant de Montjean - Briand II de Montjean - Armorial de l'Ost de Flandre
FRAAAACb - or semy-de-lis azure, a quarter gules - Guy II de Thouars - Armorial de l'Ost de Flandre
FRAAAACc - or semy-de-lis azure, on a quarter gules a sword argent - Hugues de Thouars - Armorial de l'Ost de Flandre
FRAAAACd - sable, a cross argent - Geoffroi de Kertanguy - Armorial de l'Ost de Flandre
FRAAAACe - argent, a cross gringoly gules headed or - Raoul VI de Montfort - Armorial de l'Ost de Flandre
FRAAAACf - barry ermine and gules - Pierre de Rostrenen - Armorial de l'Ost de Flandre
FRAAAACg - azure billety argent - Jean de Beaumanoir - Armorial de l'Ost de Flandre
FRAAAACh - vairy or and azure - Thibaud de Rochefort - Armorial de l'Ost de Flandre
FRAAAACi - barruly or and vert, a lion rampant gules - Gilles de Doucelles - Armorial de l'Ost de Flandre
FRAAAACj - gules, a cross patty - Olivier de Rouge - Armorial de l'Ost de Flandre
FRAAAACk - gules, three cinquefoils ermine - Geoffroi d'Ancenis - Armorial de l'Ost de Flandre
FRAAAACl - argent, three chevronels gules - Jean de Machecoul - Armorial de l'Ost de Flandre
FRAAAACm - barry argent and gules, a bendlet azure - Thibaut de Cabric - Armorial de l'Ost de Flandre
FRAAAACn - vert, a bendlet compony argent and gules - Arnould de Walhain - Armorial de l'Ost de Flandre
FRAAAACo - or, three escutcheons gules - Thiebaut IV de Mathefelon - Armorial de l'Ost de Flandre
FRAAAACp - or, a crequier gules - Guillaume de Crequy - Armorial de l'Ost de Flandre
FRAAAACq - argent, two bendlets, a bordure indented gules - Guillaume de Lières - Armorial de l'Ost de Flandre
FRAAAACr - gules semy-de-lis or - Jean VI de Chateaubriand - Armorial de l'Ost de Flandre
FRAAAACs - gules, between four lions rampant a cross or - Briant le Boeuf - Armorial de l'Ost de Flandre
FRAAAACt - or, within an orle of martlets a bend gules, a label azure - Andre de Morlaines - Armorial de l'Ost de Flandre
FRAAAACu - barruly argent and azure, a bend gules - Jean IV de Nesle - Armorial de l'Ost de Flandre
FRAAAACv - argent, on a fess gules two mullets sable - Godefroi de Ville - Armorial de l'Ost de Flandre
FRAAAACw - or, an orle of eagles displayed gules - Eschivard de Preuilly - Armorial de l'Ost de Flandre
FRAAAACx - argent, a lion rampant sable - Foucault de Montigny - Armorial de l'Ost de Flandre
FRAAAACy - azure, three eagles displayed or - Henri de Nouvion - Armorial de l'Ost de Flandre
FRAAAACz - argent, four lions rampant sable - Pierre de Fouilloy - Armorial de l'Ost de Flandre
FRAAAAC0 - argent, three torteaux - Jean II de Montigny-Olhain - Armorial de l'Ost de Flandre
FRAAAAC1 - barry wavy argent and gules, a label azure - Guillaume de la Rochechouart - Armorial de l'Ost de Flandre
FRAAAAC2 - azure, a lion rampant argent, on a chief or a bull passant gules - Arnould Berard - Armorial de l'Ost de Flandre
FRAAAAC3 - argent, a fess of lozenges gules, a label azure - Guillaume III de Chauvigny - Armorial de l'Ost de Flandre *
FRAAAAC4 - gules, on a chief or two pales vair - Itier de Magnac - Armorial de l'Ost de Flandre
FRAAAAC5 - or, a chief argent and azure, a lion rampant gules crowned or - Jean de Lignieres - Armorial de l'Ost de Flandre
FRAAAAC6 - gules fretty vair - Hugues de Surgeres - Armorial de l'Ost de Flandre
FRAAAAC7 - barruly argent and azure, a bend gules - Hugues de l'Archeveque - Armorial de l'Ost de Flandre
FRAAAAC8 - azure, a lion rampant or - Jacques de Werchin - Armorial de l'Ost de Flandre
FRAAAAC9 - argent, a lion rampant gules - Jean de Wallincourt - Armorial de l'Ost de Flandre
FRAAAAC+ - or, between three eagles gules a chevron azure - Gui II de la Tremoille - Armorial de l'Ost de Flandre
FRAAAAC/ - azure, an eagle displayed or - Miles de Noyers - Armorial de l'Ost de Flandre
FRAAAADA - or, within an orle of martlets two fesses gules , an inescutcheon: barry argent and azure, a lion rampant gules - Dreux IV de Mello - Armorial de l'Ost de Flandre
FRAAAADB - gules, a bend or - Jean de Chalon - Armorial de l'Ost de Flandre
FRAAAADC - vairy or and gules - Liebaut III de Beauffremont - Armorial de l'Ost de Flandre
FRAAAADD - argent, three cinquefoils gules - Enrart de Tramines - Armorial de l'Ost de Flandre
FRAAAADE - gules, three cinquefoils or - Jean II de Courlandon - Armorial de l'Ost de Flandre
FRAAAADF - gules, a lion rampant or - Jean IV de Thourotte - Armorial de l'Ost de Flandre
FRAAAADG - gules, a lion rampant or, a label azure - Aubert de Thourotte - Armorial de l'Ost de Flandre
FRAAAADH - or, a crequier gules - Jean de Crequy - Armorial de l'Ost de Flandre
FRAAAADI - or, a cross engrailed gules - Jean de Bouchavesnes - Armorial de l'Ost de Flandre
FRAAAADJ - gules, a cross engrailed or - Robert de Beaumetz - Armorial de l'Ost de Flandre
FRAAAADK - 
FRAAAADL - 
FRAAAADM - 
FRAAAADN - 
FRAAAADO - 
FRAAAADP - 
FRAAAADQ - 
FRAAAADR - 
FRAAAADS - 
FRAAAADT - 
FRAAAADU - 
FRAAAADV - 
FRAAAADW - 
FRAAAADX - 
FRAAAADY - 
FRAAAADZ - 
FRAAAADa - 
FRAAAADb - 
FRAAAADc - 
FRAAAADd - 
FRAAAADe - 
FRAAAADf - 
FRAAAADg - 
FRAAAADh - 
FRAAAADi - 
FRAAAADj - 
FRAAAADk - 
FRAAAADl - 
FRAAAADm - 
FRAAAADn - 
FRAAAADo - 
FRAAAADp - 
FRAAAADq - 
FRAAAADr - 
FRAAAADs - 
FRAAAADt - 
FRAAAADu - 
FRAAAADv - 
FRAAAADw - 
FRAAAADx - 
FRAAAADy - 
FRAAAADz - 
FRAAAAD0 - 
FRAAAAD1 - 
FRAAAAD2 - 
FRAAAAD3 - 
FRAAAAD4 - 
FRAAAAD5 - 
FRAAAAD6 - 
FRAAAAD7 - 
FRAAAAD8 - 
FRAAAAD9 - 
FRAAAAD+ - 
FRAAAAD/ - 

= Portuguese =

== Armorial Lusitano ==

POAAAAAA - or, within a chain of ten links in orle and bend azure two cogs chequy sable and or fimbriated gules - Abarca - Armorial Lusitano *
POAAAAAB - vert, a cross argent voided sable between four escallops or - Abasto - Armorial Lusitano
POAAAAAC - vert, - Abelho - Armorial Lusitano !!!!!
POAAAAAD - quarterly: first and fourth, chequy or and azure; second and third, or three pallets azure - Aboim - Armorial Lusitano
POAAAAAE - chequy azure and argent - Abor - Armorial Lusitano
POAAAAAF - 
POAAAAAG - 
POAAAAAH - 
POAAAAAI - 
POAAAAAJ - 
POAAAAAK - 
POAAAAAL - 
POAAAAAM - 
POAAAAAN - 
POAAAAAO - 
POAAAAAP - 
POAAAAAQ - 
POAAAAAR - 
POAAAAAS - 
POAAAAAT - 
POAAAAAU - 
POAAAAAV - 
POAAAAAW - 
POAAAAAX - 
POAAAAAY - 
POAAAAAZ - 
POAAAAAa - 
POAAAAAb - 
POAAAAAc - 
POAAAAAd - 
POAAAAAe - 
POAAAAAf - 
POAAAAAg - 
POAAAAAh - 
POAAAAAi - 
POAAAAAj - 
POAAAAAk - 
POAAAAAl - 
POAAAAAm - 
POAAAAAn - 
POAAAAAo - 
POAAAAAp - 
POAAAAAq - 
POAAAAAr - 
POAAAAAs - 
POAAAAAt - 
POAAAAAu - 
POAAAAAv - 
POAAAAAw - 
POAAAAAx - 
POAAAAAy - 
POAAAAAz - 
POAAAAA0 - 
POAAAAA1 - 
POAAAAA2 - 
POAAAAA3 - 
POAAAAA4 - 
POAAAAA5 - 
POAAAAA6 - 
POAAAAA7 - 
POAAAAA8 - 
POAAAAA9 - 
POAAAAA+ - 
POAAAAA/ - 

= Scottish =

== Balliol Roll ==

SCAAAAAA - or, within a double tressure flory-counterflory a lion rampant gules - Edward Balliol - Balliol Roll
SCAAAAAB - gules, a lion rampant or - Earl of Fife - Balliol Roll
SCAAAAAC - azure, three garbs or banded gules - Earl of Buchan - Balliol Roll
SCAAAAAD - gules, on a bordure argent eight cinquefoils pierced gules a lion rampant argent - Earl of March - Balliol Roll
SCAAAAAE - or, a saltire, on a chief gules a lion passant or - Earl of Carrick - Balliol Roll
SCAAAAAF - gules, three lions rampant argent - Earl of Ross - Balliol Roll
SCAAAAAG - argent, within a double tressure flory-counterflory three lozenges gules - Earl of Moray - Balliol Roll
SCAAAAAH - paly or and sable - Earl of Atholl - Balliol Roll
SCAAAAAI - or, two chevrons gules - Earl of Strathearn - Balliol Roll
SCAAAAAJ - or, a fess chequy argent and azure, a label gules - Earl of Menteith - Balliol Roll
SCAAAAAK - or, three mullets of six pierced gules - Earl of Sutherland - Balliol Roll
SCAAAAAL - gules, crusilly patty, a cinquefoil pierced or - Earl of Angus - Balliol Roll
SCAAAAAM - gules, a galley with pennon flying or -  - Balliol Roll
SCAAAAAN - argent, between four cinquefoils pierced a saltire gules - Earl of Lennox - Balliol Roll
SCAAAAAO - or, a fess chequy argent and azure - High Steward of Scotland - Balliol Roll
SCAAAAAP - azure, between six crosses patty fitchy a bend or - Earl of Mar - Balliol Roll
SCAAAAAQ - gules, a lion rampant argent crowned or - Moubray - Balliol Roll
SCAAAAAR - azure, three mullets of six argent pierced gules - Moray - Balliol Roll
SCAAAAAS - azure, three garbs argent banded gules - Sir Alexander Comyn - Balliol Roll
SCAAAAAT - or, three piles conjoined in point gules - Lord of Brechin - Balliol Roll
SCAAAAAU - barry argent and gules - Soulis of Liddesdale - Balliol Roll
SCAAAAAV - or, a lion rampant gules, a ribbon sable - Abernethy of that Ilk - Balliol Roll
SCAAAAAW - argent, a cross engrailed sable - Sinclair of Roslin - Balliol Roll
SCAAAAAX - argent, on a chief gules three pallets or - Keith - Balliol Roll
SCAAAAAY - or, a galley sable with dragon heads at prow and stern and flag flying all gules charged on the hull with four portholes argent - Lord of Argyll and Lorne - Balliol Roll
SCAAAAAZ - argent, a bend gules - Vaux of Dirleton - Balliol Roll
SCAAAAAa - gules, three escutcheons argent - Hay of Erroll - Balliol Roll
SCAAAAAb - argent, on a chief azure three mullets argent pierced gules - Lord of Douglas - Balliol Roll
SCAAAAAc - gules, six cinquefoils pierced argent - Fraser - Balliol Roll
SCAAAAAd - sable, a cross flory argent - Siward of Tibbers - Balliol Roll
SCAAAAAe - argent, on a bend gules three mascles or - Haliburton - Balliol Roll
SCAAAAAf - argent, on a chief sable three escallops or - Graham - Balliol Roll
SCAAAAAg - azure, three boar heads couped or armed gules -  - Balliol Roll
SCAAAAAh - sable, three fleur-de-lis argent - Harcarse of that Ilk - Balliol Roll
SCAAAAAi - azure, an orle or - Landale of that Ilk - Balliol Roll
SCAAAAAj - gules, an orle ermine - Sir Ingram of Umfraville - Balliol Roll
SCAAAAAk - 
SCAAAAAl - 
SCAAAAAm - 
SCAAAAAn - 
SCAAAAAo - 
SCAAAAAp - 
SCAAAAAq - 
SCAAAAAr - 
SCAAAAAs - 
SCAAAAAt - 
SCAAAAAu - 
SCAAAAAv - 
SCAAAAAw - 
SCAAAAAx - 
SCAAAAAy - 
SCAAAAAz - 
SCAAAAA0 - 
SCAAAAA1 - 
SCAAAAA2 - 
SCAAAAA3 - 
SCAAAAA4 - 
SCAAAAA5 - 
SCAAAAA6 - 
SCAAAAA7 - 
SCAAAAA8 - 
SCAAAAA9 - 
SCAAAAA+ - 
SCAAAAA/ - 